,count,is_written_in_last_month,is_written_in_last_week,max_created_utc,referral_utc,sub_comment_index,time_since_last_post
4,15,True,True,1464541699,1464547697,1464547697,5998
19,7,False,False,1450966590,1478588539,1478588539,27621949
31,2,True,False,1463448719,1465075160,1465075160,1626441
34,712,True,True,1451962886,1452029188,1452029188,66302
748,1,True,True,1478586993,1478598372,1478598372,11379
751,1,True,True,1476890428,1476936098,1476936098,45670
752,1,True,True,1476890428,1476935497,1476935497,45069
753,35,True,True,1473617941,1473633197,1473633197,15256
788,90,True,False,1477061806,1478629588,1478629588,1567782
887,7,True,False,1474535465,1475561438,10,1025973
899,726,True,False,1453343958,1454607188,16,1263230
1625,1,True,False,1479276880,1480168881,17,892001
1629,1,True,False,1451021115,1452373210,21,1352095
1632,33802,True,True,1475761423,1475761954,24,531
35438,5,True,True,1477674817,1477697610,31,22793
35445,1,False,False,1470187910,1473899867,35,3711957
35452,1,True,True,1465419178,1465762851,43,343673
35453,1,True,False,1470498649,1471319355,44,820706
35464,178,True,True,1467776820,1468266920,56,490100
35646,2993,True,True,1478534340,1478535195,62,855
38640,1652,True,True,1480619452,1480642460,65,23008
40292,6,False,False,1433116642,1452285327,66,19168685
40298,2,True,True,1478896701,1478902696,67,5995
40301,711,True,True,1451749594,1451845514,70,95920
41018,10,False,False,1471521823,1477928000,79,6406177
41035,7,False,False,1450966590,1478641092,88,27674502
41046,10,False,False,1453315725,1457024577,94,3708852
41057,2,True,True,1466428949,1466435892,96,6943
41065,17,True,False,1468002810,1470445085,105,2442275
41083,14,True,False,1472557061,1473624674,107,1067613
41097,12,False,False,1456321329,1465473080,108,9151751
41111,711,True,True,1451749594,1451794896,112,45302
41822,697,True,True,1451401920,1451490951,113,89031
42520,2,False,False,1468826737,1472849075,115,4022338
42522,4,False,False,1442603045,1452474477,116,9871432
42526,41,False,False,1472580858,1480284262,117,7703404
42568,73,True,True,1479821667,1479822324,119,657
42645,1,False,False,1469830825,1476462607,124,6631782
42647,1,True,True,1453260444,1453260844,126,400
42657,758,True,True,1460147630,1460405879,139,258249
43421,12,True,False,1476653596,1478491336,146,1837740
43434,575,True,True,1452279441,1452356072,148,76631
44010,1,True,True,1474574247,1475050234,152,475987
44011,2,False,False,1449594344,1472640403,154,23046059
44016,11,True,True,1474522206,1474598458,160,76252
44027,1,False,False,1440441934,1463698945,164,23257011
44031,450,True,True,1480417559,1480457539,169,39980
44484,2,True,True,1464935356,1465068857,173,133501
44493,602,True,True,1453561746,1453603125,182,41379
45097,2674,True,True,1473638414,1473707775,186,69361
47771,40,True,False,1474384222,1475300194,187,915972
47816,1,False,False,1427023089,1451995486,193,24972397
47818,8,True,False,1471612916,1473696308,195,2083392
47836,1,False,False,1432757350,1455754594,210,22997244
47840,6,True,True,1461363776,1461884946,215,521170
47846,7,False,False,1467362862,1471420614,216,4057752
47859,2,True,False,1451891385,1453048502,224,1157117
47864,29,True,False,1473863122,1474572778,228,709656
47895,2,False,False,1445268047,1451871617,231,6603570
47900,411,True,True,1452355354,1452384058,235,28704
48313,14,True,True,1464702898,1464704099,239,1201
48328,37,False,False,1472140092,1477571760,242,5431668
48370,4,False,False,1462407255,1472651716,250,10244461
48376,575,True,True,1452279441,1452354193,255,74752
48951,2144,True,True,1475318150,1475333469,256,15319
51097,1,True,True,1451677762,1452029686,259,351924
51101,8,True,True,1452020661,1452033380,264,12719
51110,1,True,True,1465419178,1465774659,266,355481
51119,680,True,True,1450873376,1450927447,276,54071
51807,41,True,True,1455514103,1455558167,285,44064
51848,1,True,True,1475516860,1475517565,286,705
51849,2,False,False,1450618262,1460643116,287,10024854
51851,1,True,True,1476890428,1476939017,288,48589
51852,5,True,True,1479493842,1479929323,289,435481
51858,5,True,False,1476939309,1477673653,292,734344
51864,1,True,True,1470934924,1470951070,294,16146
51865,1,True,True,1470934924,1470951070,295,16146
51866,3,True,True,1452012409,1452016377,296,3968
51872,689,True,True,1451274907,1451303697,301,28790
52568,1,True,True,1451900450,1452020180,309,119730
52573,5,False,False,1447881446,1463591246,314,15709800
52578,6,True,True,1467686325,1467852712,315,166387
52593,5,True,True,1454525061,1454535511,326,10450
52601,3,True,True,1472841392,1472914194,330,72802
52607,1,False,False,1425666844,1470087438,334,44420594
52608,1,False,False,1425666844,1470087438,335,44420594
52616,3058,True,True,1481561198,1481644195,346,82997
55682,2,True,True,1450927845,1450934745,357,6900
55694,2,True,True,1461314909,1461330062,375,15153
55696,36,True,False,1479238285,1480521249,376,1282964
55732,1,True,True,1470492440,1470517121,378,24681
55734,11,True,True,1461072856,1461175582,380,102726
55767,1,True,True,1474173001,1474204151,408,31150
55778,1,True,True,1466126662,1466127336,422,674
55783,25,True,True,1480576898,1480886052,428,309154
55809,1,False,False,1459030053,1482985145,430,23955092
55814,29412,True,True,1465833689,1465834128,437,439
85233,1,True,True,1472450497,1472472451,446,21954
85234,4,True,True,1459947859,1459974624,447,26765
85243,56047,True,True,1462801475,1462801674,453,199
141292,177,True,True,1463615276,1464040113,456,424837
141474,1,True,True,1454992584,1455046490,466,53906
141502,4,True,True,1459122376,1459438984,496,316608
141507,1,True,True,1461599427,1461684823,498,85396
141509,1,False,False,1448671192,1462660138,501,13988946
141510,1,False,False,1448671192,1462660138,502,13988946
141512,1,True,True,1469651197,1469651267,504,70
141522,5,False,False,1457563631,1470666568,516,13102937
141533,20,True,True,1472999552,1473500436,524,500884
141556,348,True,True,1467245533,1467246106,529,573
141904,3,False,False,1451826755,1456504602,530,4677847
141909,29,True,True,1466516056,1466561514,533,45458
141939,1,False,False,1451741711,1467981131,536,16239420
141952,2,True,True,1464453958,1464456439,550,2481
141957,25,True,False,1477068874,1477917743,556,848869
141986,12,False,False,1465140678,1470806312,562,5665634
142008,1,False,False,1431402756,1451393614,575,19990858
142019,1,True,True,1473330281,1473514832,588,184551
142021,879,True,True,1471021201,1471235175,590,213974
142910,3,True,True,1455064722,1455333436,601,268714
142923,7,True,False,1478624210,1480298695,612,1674485
142934,73058,True,True,1478547638,1478547867,617,229
215993,1,False,False,1427023089,1451984736,619,24961647
215997,5,False,False,1453824988,1479928453,625,26103465
216005,1,True,True,1480826961,1480830401,629,3440
216014,1,True,True,1466411725,1466942365,639,530640
216020,67,True,True,1471774464,1471792291,645,17827
216091,7,True,True,1471947147,1471980786,650,33639
216103,3,True,True,1473100562,1473218995,656,118433
216108,9,True,False,1453983855,1454787998,660,804143
216119,6,True,True,1454425680,1454722388,663,296708
216135,10,True,False,1453315725,1454907708,674,1591983
216148,4,False,False,1420806183,1472407720,678,51601537
216152,1,True,False,1476902613,1477590691,680,688078
216153,2,False,False,1429430173,1466040000,682,36609827
216157,1,False,False,1469660425,1472490367,686,2829942
216158,12,True,False,1448032294,1449589285,687,1556991
216190,91,True,True,1459854217,1459889104,711,34887
216282,7,True,False,1470243553,1471376208,713,1132655
216307,115,True,True,1476630771,1476718949,734,88178
216429,19,True,False,1481598123,1482422369,742,824246
216452,2,True,True,1448992859,1448993503,747,644
216458,4,True,True,1474952002,1474963965,752,11963
216463,1,False,False,1461729960,1468853308,754,7123348
216466,14,True,True,1467258582,1467263211,759,4629
216488,39,True,True,1449028259,1449029994,768,1735
216529,20,True,True,1454835643,1455299241,771,463598
216553,2,False,False,1448899745,1456069183,776,7169438
216556,5,False,False,1457102603,1464358300,778,7255697
216561,7,True,True,1466480129,1466514494,779,34365
216573,5,False,False,1452523961,1455640456,785,3116495
216579,8,True,True,1472601039,1472663525,788,62486
216588,6,True,True,1453710900,1453727718,791,16818
216594,4,True,True,1453267085,1453325521,792,58436
216599,2,True,True,1477418155,1477425246,794,7091
216613,1,True,True,1472046862,1472149588,808,102726
216615,1,True,False,1478387734,1479344383,810,956649
216616,94,True,True,1453460590,1453491220,811,30630
216710,4,True,True,1478314426,1478324503,812,10077
216720,88,True,True,1473607607,1473654925,821,47318
216812,1,True,True,1474484072,1474491527,827,7455
216813,1,True,True,1474484072,1474491527,828,7455
216831,7,False,False,1433424354,1482343581,849,48919227
216839,3,True,True,1476511417,1476858713,851,347296
216851,16,True,True,1471183108,1471356528,861,173420
216875,4,True,True,1466108164,1466117635,871,9471
216882,10,True,True,1451894553,1452290422,875,395869
216895,2,True,True,1473873601,1474193506,879,319905
216904,3,True,True,1473092263,1473111266,888,19003
216909,1,True,True,1474546337,1474555254,891,8917
216918,7,True,True,1451399490,1451399905,902,415
216929,1,True,True,1478268058,1478825788,908,557730
216933,2,False,False,1429375398,1456082472,912,26707074
216949,1,False,False,1440965056,1454268127,927,13303071
216965,5,False,False,1431439455,1459753046,947,28313591
216970,5,False,False,1431439455,1459753046,948,28313591
216976,52,True,True,1463565838,1463918452,950,352614
217035,3,False,False,1461722246,1465583877,960,3861631
217039,1,True,True,1475084937,1475097383,963,12446
217046,1284,True,True,1457289637,1457300360,971,10723
218334,5,True,True,1466487803,1466643093,976,155290
218348,1,False,False,1471305025,1474314649,986,3009624
218364,2,True,False,1461482362,1462510711,1004,1028349
218374,1,False,False,1426588965,1461248000,1019,34659035
218376,1,True,True,1477052328,1477194377,1021,142049
218377,2,True,False,1450751757,1452533236,1023,1781479
218381,102,True,True,1456423855,1456423992,1026,137
218491,18,True,True,1454537852,1454649397,1036,111545
218509,62970,True,True,1468213388,1468215782,1037,2394
281480,9,True,False,1448906973,1449697299,1039,790326
281502,11,True,True,1461072856,1461347388,1056,274532
281513,2,True,False,1454257052,1455473534,1057,1216482
281515,2,True,False,1454257052,1455473534,1058,1216482
281521,53,True,True,1477465294,1477585528,1065,120234
281576,24,True,True,1461343484,1461422417,1068,78933
281600,1925,True,True,1451414665,1451479346,1069,64681
283527,13,False,False,1438856441,1455137318,1075,16280877
283544,2,True,True,1452621186,1452634596,1080,13410
283556,1,True,True,1479674096,1479676461,1093,2365
283559,3,True,True,1464685762,1464957477,1098,271715
283562,1,False,False,1462804000,1472923176,1099,10119176
283565,7,False,False,1455566760,1459940406,1104,4373646
283577,711,True,True,1451749594,1451794997,1111,45403
284288,63,True,True,1476797669,1476967188,1112,169519
284353,1,False,False,1453231169,1460721166,1115,7489997
284356,272,True,True,1451518740,1451542334,1118,23594
284646,1,True,True,1454124118,1454449325,1141,325207
284656,4,True,True,1451681608,1451683794,1151,2186
284666,2,True,False,1467083994,1469342134,1162,2258140
284674,2,False,False,1431475151,1451449160,1171,19974009
284676,8,False,False,1461782224,1467835215,1172,6052991
284688,1,False,False,1446330295,1460481027,1177,14150732
284698,3,True,True,1459694942,1459695367,1188,425
284702,2,True,False,1452061088,1452736413,1190,675325
284704,5,True,False,1480202176,1482126623,1191,1924447
284725,3,True,False,1452594488,1454388655,1210,1794167
284730,233,True,True,1462467798,1462470742,1215,2944
284965,50,True,True,1475373155,1475411577,1218,38422
285016,26,True,False,1475078301,1475899029,1221,820728
285060,3,True,False,1468698372,1469997791,1242,1299419
285066,5,False,False,1447382356,1452263089,1247,4880733
285083,73,True,True,1483022745,1483034134,1266,11389
285162,13,True,True,1472996319,1472997448,1274,1129
285175,2,True,True,1452128981,1452129399,1275,418
285184,54,True,True,1477440830,1477473722,1285,32892
285240,2,False,False,1444033485,1449316748,1288,5283263
285252,14,False,False,1459871231,1462590063,1300,2718832
285271,1,False,False,1448132470,1462669973,1306,14537503
285285,412,True,True,1452416609,1452421091,1322,4482
285697,14,True,True,1479515414,1479565722,1323,50308
285714,122,True,True,1459985722,1460212387,1327,226665
285837,54,True,True,1477440830,1477473674,1330,32844
285902,879,True,True,1482524162,1482525232,1344,1070
286785,2,True,False,1450751757,1452491513,1350,1739756
286788,29,True,True,1451652340,1451771944,1352,119604
286830,58,True,True,1454454997,1454458310,1372,3313
286897,2,True,True,1449338774,1449523777,1382,185003
286908,2,False,False,1466210294,1468842656,1392,2632362
286914,2,False,False,1444326943,1461819482,1398,17492539
286920,73,False,False,1455772682,1463955810,1403,8183128
286993,3,False,False,1453538679,1469219361,1404,15680682
287002,5,True,True,1456329279,1456347342,1411,18063
287007,9,True,True,1452814546,1452858224,1412,43678
287018,1,True,False,1449491023,1450878505,1415,1387482
287019,47,True,True,1451802626,1451975213,1416,172587
287067,22,True,True,1461683251,1462043926,1418,360675
287089,6,True,False,1461248133,1462771094,1419,1522961
287108,2,True,True,1475603736,1475659570,1436,55834
287118,98,True,True,1461938456,1462375484,1445,437028
287217,1,False,False,1433874567,1476375562,1447,42500995
287218,49,True,True,1479162751,1479180831,1448,18080
287275,50,True,True,1463990532,1464176269,1457,185737
287329,4,True,True,1480681638,1480908068,1462,226430
287335,17,True,False,1468002810,1470456434,1465,2453624
287357,35,True,True,1461658570,1461690955,1472,32385
287403,3,False,False,1441987670,1462800198,1485,20812528
287410,36,True,True,1461692218,1461725460,1490,33242
287452,5,True,False,1464064333,1465008285,1497,943952
287459,3,False,False,1440694735,1460557473,1501,19862738
287466,83,True,True,1452563951,1452567273,1507,3322
287555,5,False,False,1434631188,1467290700,1516,32659512
287561,1,True,True,1453897979,1453898308,1518,329
287564,36,True,True,1450933720,1451422379,1522,488659
287600,1,False,False,1450574134,1472606209,1523,22032075
287602,15,True,True,1458643428,1458755199,1525,111771
287618,1,True,True,1482740964,1482807367,1527,66403
287628,1,True,True,1474374994,1474541078,1538,166084
287630,153,True,True,1467371035,1467475364,1540,104329
287783,33,False,False,1456024693,1460780098,1542,4755405
287821,3,False,False,1469661228,1482858899,1548,13197671
287838,56628,True,True,1463158608,1463159121,1564,513
344473,11,False,False,1460437818,1464023077,1572,3585259
344490,3,True,False,1475884753,1476837178,1579,952425
344495,71,True,True,1479450974,1479475762,1582,24788
344568,7,True,True,1451600961,1451606878,1585,5917
344582,4,False,False,1457061519,1465582093,1596,8520574
344591,81,True,True,1482240867,1482334508,1602,93641
344672,9729,True,True,1475173765,1475175383,1603,1618
354403,585,True,True,1455490036,1455542621,1606,52585
354994,1,True,True,1479246989,1479249536,1614,2547
355005,3,True,False,1474987183,1477185092,1627,2197909
355016,3,False,False,1453147471,1456225607,1637,3078136
355028,5,True,True,1454185648,1454474290,1652,288642
355033,5,True,True,1454185648,1454474290,1653,288642
355050,16,False,False,1455396294,1459000380,1668,3604086
355080,12,True,True,1459283506,1459478287,1685,194781
355095,1,False,False,1437579232,1456326782,1691,18747550
355099,5,False,False,1427001518,1456831179,1697,29829661
355105,1,False,False,1421150106,1461513285,1699,40363179
355107,3,True,True,1462642972,1462725977,1701,83005
355114,23,True,True,1473043076,1473171863,1706,128787
355138,1,True,True,1476202279,1476209514,1710,7235
355139,3,False,False,1454727065,1457462976,1711,2735911
355147,3,True,True,1451252285,1451253808,1718,1523
355163,9,True,True,1457468464,1457544807,1734,76343
355180,11,True,True,1455635449,1455643049,1745,7600
355202,1,False,False,1466859083,1473417020,1759,6557937
355207,5,True,True,1476746679,1476761523,1764,14844
355225,11,False,False,1427679441,1469555102,1782,41875661
355236,27,True,False,1469468407,1470434278,1783,965871
355265,7,False,False,1435720117,1458103522,1788,22383405
355280,417,True,True,1451867868,1451899834,1798,31966
355700,937,True,True,1475586140,1475588285,1802,2145
356638,4,True,True,1449351586,1449361106,1804,9520
356650,3,True,False,1463119097,1464175631,1813,1056534
356665,1,True,True,1469062803,1469069348,1829,6545
356668,931,True,True,1475506706,1475513174,1832,6468
357599,40978,True,True,1452370378,1452371384,1835,1006
398580,29,True,True,1451652340,1451770316,1839,117976
398624,188,False,False,1452752262,1460776412,1858,8024150
398814,2,False,False,1455828516,1462318117,1861,6489601
398824,5,True,True,1451760336,1451797431,1871,37095
398831,3,True,False,1468799695,1469413620,1875,613925
398834,146,True,True,1481997264,1482224190,1876,226926
398985,830,True,True,1452358209,1452358317,1882,108
399818,5,True,False,1452121737,1453205434,1887,1083697
399827,2,True,False,1474063409,1475526325,1892,1462916
399829,54843,True,True,1461954340,1461955074,1893,734
454672,1,True,False,1451932623,1452610402,1894,677779
454684,1,True,True,1475084937,1475085684,1907,747
454690,39,True,False,1458704547,1459612812,1913,908265
454734,2,False,False,1445268047,1451946483,1919,6678436
454742,2,False,False,1429296813,1469917718,1927,40620905
454744,2,False,False,1468177630,1478024265,1928,9846635
454752,1,True,True,1466301148,1466356855,1935,55707
454761,1,False,False,1469020060,1474426619,1946,5406559
454770,2,True,False,1481254228,1482730385,1955,1476157
454777,1,True,False,1451021115,1452374737,1962,1353622
454778,88,True,True,1473607607,1473655096,1963,47489
454867,16,True,True,1453708816,1454087079,1965,378263
454884,12,True,True,1471744816,1472086904,1967,342088
454900,321,True,True,1480399460,1480445393,1973,45933
455226,1,True,False,1451951369,1453133976,1980,1182607
455229,3,True,True,1457036158,1457037686,1983,1528
455236,2,False,False,1463056445,1473269127,1988,10212682
455250,5,True,True,1466487803,1466642062,2003,154259
455255,1,False,False,1421150106,1461264611,2004,40114505
455257,19,True,True,1473894073,1473935241,2007,41168
455283,20,False,False,1455713858,1463584515,2016,7870657
455309,2,True,True,1452962582,1453165418,2023,202836
455319,88,True,True,1473607607,1473654805,2034,47198
455409,1,True,True,1481259999,1481689518,2037,429519
455413,247,True,False,1460009732,1461128885,2041,1119153
455665,18,False,False,1474603247,1477394314,2047,2791067
455684,5,False,False,1439593615,1454616229,2049,15022614
455707,1,True,True,1457360720,1457445669,2074,84949
455717,8,False,False,1453713240,1472144623,2087,18431383
455725,5,True,False,1458583182,1459451820,2088,868638
455732,3,True,False,1469414097,1470847055,2091,1432958
455736,3,True,True,1467606030,1467938185,2093,332155
455742,4,True,True,1459947859,1459979910,2098,32051
455747,15,True,True,1456273322,1456708345,2100,435023
455768,12,True,True,1474079183,1474079997,2107,814
455780,160,True,False,1457240149,1458587206,2108,1347057
455940,1,False,False,1438217829,1459490206,2109,21272377
455943,4,True,False,1451287244,1453066055,2112,1778811
455965,1,True,True,1475029644,1475061765,2132,32121
455971,1,True,True,1456883863,1456884872,2139,1009
455981,22,True,True,1452940638,1452964093,2152,23455
456013,3258,True,True,1463589789,1463593640,2164,3851
459271,711,True,True,1451749594,1451768205,2165,18611
459990,6,False,False,1457495952,1463127484,2176,5631532
459998,1,False,False,1446672993,1456261719,2179,9588726
460001,1407,True,True,1470489495,1470661119,2184,171624
461409,3,True,True,1450425491,1450425558,2186,67
461415,9,True,True,1452617991,1453146866,2190,528875
461425,1,True,True,1477526229,1477530411,2196,4182
461426,1,True,True,1477526229,1477530411,2197,4182
461427,1,True,True,1469342607,1469390017,2200,47410
461428,1,True,True,1469342607,1469390017,2201,47410
461431,3,False,False,1423508592,1456030734,2204,32522142
461434,3,False,False,1423508592,1456030734,2205,32522142
461465,32,False,False,1450834421,1459721367,2236,8886946
461507,1,True,True,1464042398,1464463344,2250,420946
461528,2,True,False,1460823824,1461563094,2274,739270
461530,2,True,False,1460823824,1461563094,2275,739270
461542,43,True,True,1455284665,1455301485,2287,16820
461587,1,True,True,1464323906,1464347415,2290,23509
461592,1,False,False,1445758034,1470349251,2295,24591217
461593,1,True,False,1480009991,1481717604,2296,1707613
461595,1909,True,True,1457210400,1457212559,2299,2159
463507,3,True,False,1455846315,1456631694,2303,785379
463517,5,True,False,1477866412,1480344399,2313,2477987
463533,1,True,False,1465638476,1466942014,2326,1303538
463540,1,True,False,1465501318,1468069652,2336,2568334
463553,1,True,True,1452813829,1452899636,2352,85807
463555,31,True,True,1473191874,1473225729,2354,33855
463590,3,False,False,1436517152,1460786753,2359,24269601
463594,1,True,True,1462908060,1462961730,2361,53670
463604,1639,True,True,1455911266,1455911408,2372,142
465243,1,True,True,1478586993,1478628340,2373,41347
465244,1,False,False,1436237230,1483231851,2374,46994621
465248,16,True,True,1454001794,1454357279,2379,355485
465264,5,False,False,1454438224,1466987458,2380,12549234
465269,6,False,False,1425564590,1477514015,2381,51949425
465275,6,False,False,1425564590,1477514015,2382,51949425
465284,313,True,True,1454218506,1454282529,2387,64023
465597,341,True,True,1482151242,1482155155,2388,3913
465942,2,False,False,1458663045,1468394422,2393,9731377
465945,2,True,True,1462293390,1462672897,2395,379507
465947,798,True,True,1462236663,1462554496,2396,317833
466745,3,True,True,1460678002,1460723205,2397,45203
466750,403,True,True,1466011484,1466014800,2400,3316
467156,7,False,False,1455566760,1459834816,2405,4268056
467163,7,False,False,1455566760,1459834816,2406,4268056
467186,17,True,True,1462249061,1462255792,2428,6731
467203,11,True,True,1482539706,1482620406,2429,80700
467219,13,True,False,1470647503,1471615021,2435,967518
467233,1,False,False,1452070864,1473009946,2437,20939082
467243,86,True,True,1459249345,1459356673,2449,107328
467342,4,True,True,1471241599,1471314483,2466,72884
467346,169,True,True,1456398162,1456425598,2467,27436
467527,1,True,False,1472547528,1474291447,2484,1743919
467533,4,True,False,1460859103,1462986610,2490,2127507
467542,2,True,False,1457313453,1458062628,2497,749175
467553,37,True,False,1474903964,1477415667,2507,2511703
467600,19,True,True,1468957847,1469205251,2518,247404
467619,34,True,True,1468010057,1468016951,2519,6894
467656,1,True,True,1456892922,1456893113,2524,191
467671,35,True,True,1451420079,1451833375,2542,413296
467707,333,True,True,1481090685,1481149378,2544,58693
468040,1,False,False,1470202209,1479849584,2545,9647375
468041,1,False,False,1426581864,1454414784,2547,27832920
468057,11,True,True,1466681742,1466712219,2566,30477
468068,2,True,True,1451450716,1451956068,2567,505352
468083,1,False,False,1440855406,1458311248,2584,17455842
468084,47,True,True,1454585546,1454602198,2585,16652
468134,36,True,True,1454550690,1454764988,2590,214298
468178,10,False,False,1463957558,1469031268,2599,5073710
468190,44,False,False,1452464852,1470661679,2603,18196827
468241,57,True,True,1476496568,1477092519,2612,595951
468298,10,True,False,1473366215,1474686583,2613,1320368
468308,70,True,True,1478896469,1479000489,2614,104020
468382,1,True,True,1460770949,1461293174,2619,522225
468392,2,True,True,1481463928,1481739541,2630,275613
468404,3,True,True,1472024543,1472607871,2645,583328
468408,3,False,False,1447384368,1456330611,2647,8946243
468422,1,True,False,1470686019,1471536453,2660,850434
468437,6,True,True,1450762478,1450797685,2676,35207
468445,27164,True,True,1459629971,1459654609,2680,24638
495612,102,True,True,1479715352,1480174958,2685,459606
495718,24,False,False,1470969433,1473906923,2692,2937490
495743,3,True,True,1466590613,1466591111,2694,498
495755,7,False,False,1443044876,1449365279,2704,6320403
495762,1,True,True,1470492440,1470508916,2705,16476
495767,3,False,False,1429122462,1456853014,2711,27730552
495770,1,False,False,1421098886,1473532652,2712,52433766
495776,2,True,True,1452785153,1452785850,2720,697
495781,6,True,True,1457810012,1458410942,2724,600930
495793,10,False,False,1464027569,1479407904,2731,15380335
495803,15,True,False,1466687752,1467937531,2732,1249779
495820,762,True,True,1460472388,1460473116,2736,728
496594,54,True,True,1463276606,1463285847,2749,9241
496654,3,True,True,1460473587,1460499326,2756,25739
496660,10,True,True,1449773863,1450224166,2760,450303
496670,1,True,True,1460648077,1460665086,2761,17009
496678,10,True,False,1452001361,1453913472,2770,1912111
496693,5,False,False,1470371569,1473646728,2778,3275159
496698,10,True,True,1467400358,1467693126,2779,292768
496711,1,True,True,1476128151,1476130134,2783,1983
496720,11,True,True,1452763349,1452764350,2795,1001
496735,1,False,False,1423959157,1464587460,2800,40628303
496737,919,True,True,1464919997,1464972944,2803,52947
497659,17,True,True,1462887256,1462911520,2808,24264
497679,471,True,True,1450380078,1450550103,2818,170025
498155,2,False,False,1474904954,1479703015,2825,4798061
498157,1,True,True,1455754891,1455756651,2826,1760
498159,54,True,True,1465200132,1465316735,2829,116603
498218,11,False,False,1460437818,1464115061,2836,3677243
498232,1,False,False,1422189299,1453360274,2840,31170975
498235,7,True,True,1454136963,1454193059,2843,56096
498249,12,False,False,1446906494,1467655837,2852,20749343
498261,1,True,True,1452147832,1452221866,2853,74034
498272,19,True,True,1468957847,1469207927,2864,250080
498292,4,True,False,1453225253,1455219395,2866,1994142
498303,1,False,False,1434929414,1451678306,2877,16748892
498304,166,True,True,1469380132,1469399659,2878,19527
498470,1,False,False,1472917599,1481251585,2880,8333986
498472,3,False,False,1434906465,1475767013,2882,40860548
498476,5,True,True,1455196133,1455196356,2884,223
498481,1,True,True,1454986637,1454987803,2885,1166
498483,2,True,True,1464275541,1464347974,2887,72433
498492,2,False,False,1456927960,1459946687,2897,3018727
498501,15,False,False,1455133691,1477627736,2906,22494045
498516,126,True,True,1464087805,1464154827,2907,67022
498646,1,True,False,1451271314,1452612678,2912,1341364
498647,12,False,False,1448318716,1452816816,2913,4498100
498659,21,True,True,1453141288,1453148246,2914,6958
498681,6,True,True,1451939939,1452523046,2917,583107
498687,7,True,True,1452479139,1452742911,2918,263772
498694,6,True,False,1451939939,1454302959,2920,2363020
498700,3,True,False,1455289585,1456326316,2921,1036731
498704,1,True,True,1452044489,1452353264,2923,308775
498705,2,True,False,1452061088,1452736164,2924,675076
498707,2,True,True,1452168880,1452281759,2925,112879
498709,5,False,False,1446684559,1454596828,2926,7912269
498714,7,False,False,1455635781,1461869197,2927,6233416
498721,12,False,False,1445198167,1456118860,2929,10920693
498733,32,True,False,1452008543,1452770440,2930,761897
498767,756,True,True,1464320878,1464345336,2935,24458
499526,1,True,True,1451965428,1452528191,2939,562763
499527,1,True,True,1476890428,1476991397,2940,100969
499529,1,False,False,1459998064,1472147214,2942,12149150
499531,396,True,True,1477082685,1477126287,2944,43602
499937,5,False,False,1470371569,1473646998,2955,3275429
499942,10,True,True,1467138704,1467138784,2956,80
499956,1,True,False,1471103037,1473571885,2962,2468848
499957,54,False,False,1474653191,1480893124,2963,6239933
500012,24,True,True,1480811387,1480820182,2965,8795
500036,13,True,True,1451981799,1451982334,2966,535
500052,81,True,True,1482240867,1482253766,2971,12899
500134,63,True,True,1456484613,1456703428,2973,218815
500202,1,False,False,1437775519,1466601606,2979,28826087
500207,4,False,False,1454724708,1457527743,2985,2803035
500214,62,True,True,1459961529,1459991747,2989,30218
500279,5,True,True,1450469614,1450680479,2993,210865
500290,3,True,True,1464552769,1464695938,3003,143169
500297,4,False,False,1459077005,1468679468,3010,9602463
500305,5,True,True,1472574234,1472574476,3018,242
500310,17,False,False,1455085491,1462200094,3019,7114603
500335,1,False,False,1451741711,1460514555,3030,8772844
500337,1743,True,True,1482256709,1482264284,3032,7575
502083,12,True,False,1477271542,1479319182,3039,2047640
502101,52,True,True,1463717865,1464205147,3046,487282
502155,90,True,True,1473676618,1473719563,3049,42945
502245,8,True,True,1460147656,1460407869,3050,260213
502261,203,True,True,1473401098,1473446875,3059,45777
502464,5,False,False,1423534172,1451147961,3060,27613789
502473,5,True,True,1476751879,1476907659,3065,155780
502481,2,False,False,1424190187,1472775074,3069,48584887
502491,15,False,False,1450143334,1454624597,3079,4481263
502506,3,True,True,1450854950,1450873836,3080,18886
502515,2,False,False,1446399885,1451326281,3088,4926396
502518,1,False,False,1454467471,1459618873,3090,5151402
502528,3,True,False,1474474681,1476755533,3101,2280852
502534,711,True,True,1451749594,1451955544,3107,205950
503249,2,False,False,1473014024,1481314797,3112,8300773
503253,103,True,True,1471991227,1472021415,3116,30188
503371,1,False,False,1429212191,1468819753,3133,39607562
503376,35,True,True,1467604995,1467833089,3140,228094
503418,4,True,True,1464287072,1464732091,3151,445019
503423,13897,True,True,1482346528,1482347205,3155,677
517321,230,True,True,1449934424,1450028162,3157,93738
517555,3,False,False,1458739981,1462460018,3163,3720037
517558,1377,True,True,1452356310,1452379517,3164,23207
518936,29,False,False,1442724866,1452008293,3166,9283427
518965,977,True,True,1482941442,1482941668,3167,226
519946,3,False,False,1440443480,1482621076,3174,42177596
519949,3,True,True,1473092263,1473111359,3176,19096
519953,56,True,True,1455620641,1455737125,3178,116484
520010,720,True,True,1469048235,1469109463,3181,61228
520738,2,False,False,1430739397,1453073370,3192,22333973
520743,18,False,False,1474603247,1477410690,3196,2807443
520771,3,False,False,1466010899,1475942578,3207,9931679
520775,1,False,False,1426581864,1454499740,3209,27917876
520776,2,True,True,1451873830,1451940650,3210,66820
520779,51,True,True,1468896319,1469419982,3212,523663
520831,1,False,False,1449130237,1457795203,3216,8664966
520833,1,True,True,1459824612,1459824830,3218,218
520840,54,True,True,1474058057,1474346037,3225,287980
520904,138,True,True,1454794467,1454796899,3239,2432
521059,1,False,False,1462270923,1465210902,3258,2939979
521071,4,True,True,1473787473,1473858744,3272,71271
521076,1,True,True,1457803553,1457887398,3274,83845
521083,18,True,False,1469795234,1471958436,3281,2163202
521113,7,False,False,1477833998,1483071687,3296,5237689
521122,2,True,False,1450217105,1452371551,3299,2154446
521128,11,True,True,1476989537,1477007176,3305,17639
521143,1,True,True,1454639420,1455045027,3310,405607
521146,1,False,False,1454026651,1472027804,3313,18001153
521148,665,True,True,1458679205,1458681159,3315,1954
521814,5,True,True,1450554706,1450936929,3317,382223
521819,1,True,False,1477942679,1479088270,3318,1145591
521822,1,False,False,1447869489,1454535353,3321,6665864
521829,1,True,True,1477962770,1478047795,3328,85025
521839,431,True,True,1476389213,1476825387,3338,436174
522270,1,False,False,1462208190,1475080301,3339,12872111
522274,21,True,False,1469278061,1471678342,3344,2400281
522296,1,True,True,1459181761,1459181946,3346,185
522300,5,True,True,1473431130,1473431271,3350,141
522309,6,True,True,1473706899,1473727870,3356,20971
522315,49,True,True,1482557007,1482557251,3357,244
522366,3,False,False,1468871771,1473010747,3360,4138976
522369,2,True,True,1469290504,1469611875,3361,321371
522376,11,True,True,1453990348,1454521273,3367,530925
0,0,False,False,1460913020,1460913020,1460913020,0
1,0,False,False,1473543486,1473543486,1473543486,0
2,0,False,False,1478549994,1478549994,1478549994,0
3,0,False,False,1478538269,1478538269,1478538269,0
26,0,False,False,1459359586,1459359586,1459359586,0
27,0,False,False,1476523181,1476523181,1476523181,0
28,0,False,False,1479296510,1479296510,1479296510,0
29,0,False,False,1475119363,1475119363,1475119363,0
30,0,False,False,1475103390,1475103390,1475103390,0
33,0,False,False,1452029958,1452029958,1452029958,0
746,0,False,False,1457976364,1457976364,1457976364,0
747,0,False,False,1470849341,1470849341,1470849341,0
749,0,False,False,1474750027,1474750027,1474750027,0
750,0,False,False,1474578847,1474578847,1474578847,0
878,0,False,False,1461794140,1461794140,1461794140,0
879,0,False,False,1480448365,1480448365,1,0
880,0,False,False,1464138969,1464138969,2,0
881,0,False,False,1475937199,1475937199,3,0
882,0,False,False,1476034253,1476034253,5,0
883,0,False,False,1475600789,1475600789,6,0
884,0,False,False,1477094910,1477094910,7,0
885,0,False,False,1456785783,1456785783,8,0
886,0,False,False,1452521258,1452521258,9,0
894,0,False,False,1476235474,1476235474,11,0
895,0,False,False,1474298064,1474298064,12,0
896,0,False,False,1474298649,1474298649,13,0
897,0,False,False,1479853719,1479853719,14,0
898,0,False,False,1452867133,1452867133,15,0
1626,0,False,False,1473868867,1473868867,18,0
1627,0,False,False,1474143156,1474143156,19,0
1628,0,False,False,1475456908,1475456908,20,0
1630,0,False,False,1478603688,1478603688,22,0
1631,0,False,False,1473575346,1473575346,23,0
35434,0,False,False,1475812572,1475812572,25,0
35435,0,False,False,1481378604,1481378604,26,0
35436,0,False,False,1480467515,1480467515,29,0
35437,0,False,False,1461707961,1461707961,30,0
35443,0,False,False,1474768733,1474768733,32,0
35444,0,False,False,1473946052,1473946052,34,0
35446,0,False,False,1457717655,1457717655,36,0
35447,0,False,False,1468610191,1468610191,38,0
35448,0,False,False,1467110681,1467110681,39,0
35449,0,False,False,1480021020,1480021020,40,0
35450,0,False,False,1462663436,1462663436,41,0
35451,0,False,False,1481374617,1481374617,42,0
35454,0,False,False,1479912433,1479912433,46,0
35455,0,False,False,1471872805,1471872805,47,0
35456,0,False,False,1459719292,1459719292,48,0
35457,0,False,False,1467341649,1467341649,49,0
35458,0,False,False,1472737179,1472737179,50,0
35459,0,False,False,1471047401,1471047401,51,0
35460,0,False,False,1480439987,1480439987,52,0
35461,0,False,False,1477565791,1477565791,53,0
35462,0,False,False,1479833243,1479833243,54,0
35463,0,False,False,1477594848,1477594848,55,0
35642,0,False,False,1480203745,1480203745,58,0
35643,0,False,False,1457960729,1457960729,59,0
35644,0,False,False,1452112933,1452112933,60,0
35645,0,False,False,1476979019,1476979019,61,0
38639,0,False,False,1476301617,1476301617,63,0
40300,0,False,False,1471662365,1471662365,69,0
41012,0,False,False,1478871167,1478871167,71,0
41013,0,False,False,1463463184,1463463184,72,0
41014,0,False,False,1480529471,1480529471,74,0
41015,0,False,False,1473783808,1473783808,75,0
41016,0,False,False,1479754539,1479754539,77,0
41017,0,False,False,1457042896,1457042896,78,0
41028,0,False,False,1480223883,1480223883,80,0
41029,0,False,False,1480244267,1480244267,82,0
41030,0,False,False,1450989728,1450989728,83,0
41031,0,False,False,1476388555,1476388555,84,0
41032,0,False,False,1468426649,1468426649,85,0
41033,0,False,False,1477586754,1477586754,86,0
41034,0,False,False,1479895386,1479895386,87,0
41042,0,False,False,1475677906,1475677906,89,0
41043,0,False,False,1480125631,1480125631,90,0
41044,0,False,False,1475131341,1475131341,91,0
41045,0,False,False,1472602957,1472602957,93,0
41056,0,False,False,1479816193,1479816193,95,0
41059,0,False,False,1473432492,1473432492,97,0
41060,0,False,False,1457044594,1457044594,98,0
41061,0,False,False,1479482166,1479482166,101,0
41062,0,False,False,1466347377,1466347377,102,0
41063,0,False,False,1472465248,1472465248,103,0
41064,0,False,False,1472617052,1472617052,104,0
41082,0,False,False,1478779275,1478779275,106,0
41109,0,False,False,1470879400,1470879400,110,0
41110,0,False,False,1476136596,1476136596,111,0
42519,0,False,False,1480513327,1480513327,114,0
42567,0,False,False,1461782613,1461782613,118,0
42641,0,False,False,1468506820,1468506820,120,0
42642,0,False,False,1456940377,1456940377,121,0
42643,0,False,False,1476978901,1476978901,122,0
42644,0,False,False,1471549603,1471549603,123,0
42646,0,False,False,1456371713,1456371713,125,0
42648,0,False,False,1476923562,1476923562,130,0
42649,0,False,False,1472414234,1472414234,131,0
42650,0,False,False,1474748965,1474748965,132,0
42651,0,False,False,1474635177,1474635177,133,0
42652,0,False,False,1478709875,1478709875,134,0
42653,0,False,False,1464879670,1464879670,135,0
42654,0,False,False,1472249505,1472249505,136,0
42655,0,False,False,1475700664,1475700664,137,0
42656,0,False,False,1474540926,1474540926,138,0
43415,0,False,False,1479911461,1479911461,140,0
43416,0,False,False,1460893215,1460893215,141,0
43417,0,False,False,1471691892,1471691892,142,0
43418,0,False,False,1480010928,1480010928,143,0
43419,0,False,False,1478955688,1478955688,144,0
43420,0,False,False,1455669814,1455669814,145,0
43433,0,False,False,1466621157,1466621157,147,0
44009,0,False,False,1478102611,1478102611,151,0
44013,0,False,False,1453386668,1453386668,155,0
44014,0,False,False,1479922051,1479922051,158,0
44015,0,False,False,1476166383,1476166383,159,0
44028,0,False,False,1469931800,1469931800,165,0
44029,0,False,False,1480349450,1480349450,166,0
44030,0,False,False,1478616705,1478616705,167,0
44481,0,False,False,1457039684,1457039684,170,0
44482,0,False,False,1477945680,1477945680,171,0
44483,0,False,False,1480385477,1480385477,172,0
44486,0,False,False,1453177831,1453177831,174,0
44487,0,False,False,1479661847,1479661847,175,0
44488,0,False,False,1454521197,1454521197,176,0
44489,0,False,False,1476823793,1476823793,177,0
44490,0,False,False,1480393079,1480393079,178,0
44491,0,False,False,1478277476,1478277476,179,0
44492,0,False,False,1478107362,1478107362,181,0
45095,0,False,False,1472606938,1472606938,183,0
45096,0,False,False,1470281304,1470281304,184,0
47811,0,False,False,1472203637,1472203637,188,0
47812,0,False,False,1477886534,1477886534,189,0
47813,0,False,False,1479741465,1479741465,190,0
47814,0,False,False,1480293872,1480293872,191,0
47815,0,False,False,1479940151,1479940151,192,0
47817,0,False,False,1462639233,1462639233,194,0
47826,0,False,False,1479397805,1479397805,196,0
47827,0,False,False,1470668947,1470668947,198,0
47828,0,False,False,1475931721,1475931721,199,0
47829,0,False,False,1466402980,1466402980,201,0
47830,0,False,False,1453901735,1453901735,202,0
47831,0,False,False,1450038090,1450038090,203,0
47832,0,False,False,1452859784,1452859784,204,0
47833,0,False,False,1475878141,1475878141,205,0
47834,0,False,False,1472396593,1472396593,207,0
47835,0,False,False,1477801854,1477801854,209,0
47837,0,False,False,1478199047,1478199047,211,0
47838,0,False,False,1457704941,1457704941,212,0
47839,0,False,False,1474290475,1474290475,214,0
47853,0,False,False,1476900999,1476900999,217,0
47854,0,False,False,1478184777,1478184777,219,0
47855,0,False,False,1477822418,1477822418,220,0
47856,0,False,False,1472810048,1472810048,221,0
47857,0,False,False,1455928678,1455928678,222,0
47858,0,False,False,1476963357,1476963357,223,0
47861,0,False,False,1474310174,1474310174,225,0
47862,0,False,False,1474001471,1474001471,226,0
47863,0,False,False,1475549072,1475549072,227,0
47893,0,False,False,1477655709,1477655709,229,0
47894,0,False,False,1474224488,1474224488,230,0
47897,0,False,False,1466464401,1466464401,232,0
47898,0,False,False,1477555592,1477555592,233,0
47899,0,False,False,1473967774,1473967774,234,0
48311,0,False,False,1453736559,1453736559,236,0
48312,0,False,False,1478458177,1478458177,238,0
48327,0,False,False,1479769292,1479769292,240,0
48365,0,False,False,1480064067,1480064067,243,0
48366,0,False,False,1475700087,1475700087,244,0
48367,0,False,False,1474630966,1474630966,246,0
48368,0,False,False,1467867768,1467867768,247,0
48369,0,False,False,1479915714,1479915714,249,0
48374,0,False,False,1476277764,1476277764,252,0
48375,0,False,False,1473592113,1473592113,253,0
51095,0,False,False,1468541625,1468541625,257,0
51096,0,False,False,1480029368,1480029368,258,0
51098,0,False,False,1455370903,1455370903,261,0
51099,0,False,False,1479764391,1479764391,262,0
51100,0,False,False,1453684149,1453684149,263,0
51109,0,False,False,1480150769,1480150769,265,0
51111,0,False,False,1478522231,1478522231,267,0
51112,0,False,False,1466013301,1466013301,268,0
51113,0,False,False,1472833111,1472833111,270,0
51114,0,False,False,1471210702,1471210702,271,0
51115,0,False,False,1471028604,1471028604,272,0
51116,0,False,False,1469928138,1469928138,273,0
51117,0,False,False,1456744242,1456744242,274,0
51118,0,False,False,1480280208,1480280208,275,0
51799,0,False,False,1476812371,1476812371,277,0
51800,0,False,False,1456513244,1456513244,278,0
51801,0,False,False,1479759586,1479759586,279,0
51802,0,False,False,1466569686,1466569686,280,0
51803,0,False,False,1450127070,1450127070,281,0
51804,0,False,False,1475907165,1475907165,282,0
51805,0,False,False,1479409062,1479409062,283,0
51806,0,False,False,1473942216,1473942216,284,0
51857,0,False,False,1460210101,1460210101,290,0
51863,0,False,False,1468543443,1468543443,293,0
51869,0,False,False,1473226532,1473226532,297,0
51870,0,False,False,1475621728,1475621728,298,0
51871,0,False,False,1480895868,1480895868,300,0
52561,0,False,False,1477077593,1477077593,302,0
52562,0,False,False,1477012247,1477012247,303,0
52563,0,False,False,1479180625,1479180625,304,0
52564,0,False,False,1459789799,1459789799,305,0
52565,0,False,False,1480173461,1480173461,306,0
52566,0,False,False,1475820876,1475820876,307,0
52567,0,False,False,1475820876,1475820876,308,0
52569,0,False,False,1475415029,1475415029,310,0
52570,0,False,False,1459581275,1459581275,311,0
52571,0,False,False,1479144903,1479144903,312,0
52572,0,False,False,1475169298,1475169298,313,0
52584,0,False,False,1461196422,1461196422,316,0
52585,0,False,False,1464613982,1464613982,317,0
52586,0,False,False,1470817253,1470817253,318,0
52587,0,False,False,1470817253,1470817253,319,0
52588,0,False,False,1453318572,1453318572,320,0
52589,0,False,False,1482023680,1482023680,321,0
52590,0,False,False,1480378894,1480378894,323,0
52591,0,False,False,1480453967,1480453967,324,0
52592,0,False,False,1474589422,1474589422,325,0
52598,0,False,False,1471801504,1471801504,327,0
52599,0,False,False,1454201657,1454201657,328,0
52600,0,False,False,1468503436,1468503436,329,0
52604,0,False,False,1478163502,1478163502,331,0
52605,0,False,False,1452801063,1452801063,332,0
52606,0,False,False,1464207608,1464207608,333,0
52609,0,False,False,1469069883,1469069883,337,0
52610,0,False,False,1476145395,1476145395,338,0
52611,0,False,False,1475008828,1475008828,340,0
52612,0,False,False,1480519444,1480519444,341,0
52613,0,False,False,1461620937,1461620937,343,0
52614,0,False,False,1467899585,1467899585,344,0
52615,0,False,False,1482016753,1482016753,345,0
55674,0,False,False,1470437735,1470437735,347,0
55675,0,False,False,1476620591,1476620591,349,0
55676,0,False,False,1476133998,1476133998,350,0
55677,0,False,False,1478869361,1478869361,351,0
55678,0,False,False,1467086043,1467086043,352,0
55679,0,False,False,1467668767,1467668767,353,0
55680,0,False,False,1468357717,1468357717,355,0
55681,0,False,False,1477153117,1477153117,356,0
55684,0,False,False,1450052916,1450052916,358,0
55685,0,False,False,1452686758,1452686758,359,0
55686,0,False,False,1481407682,1481407682,360,0
55687,0,False,False,1470187904,1470187904,362,0
55688,0,False,False,1456323701,1456323701,364,0
55689,0,False,False,1449003525,1449003525,369,0
55690,0,False,False,1481741524,1481741524,370,0
55691,0,False,False,1477017465,1477017465,371,0
55692,0,False,False,1481142077,1481142077,372,0
55693,0,False,False,1464626797,1464626797,374,0
55733,0,False,False,1478490820,1478490820,379,0
55745,0,False,False,1450499494,1450499494,381,0
55746,0,False,False,1478008680,1478008680,382,0
55747,0,False,False,1472597914,1472597914,383,0
55748,0,False,False,1478416916,1478416916,384,0
55749,0,False,False,1483093271,1483093271,385,0
55750,0,False,False,1467019042,1467019042,386,0
55751,0,False,False,1473071288,1473071288,387,0
55752,0,False,False,1452480304,1452480304,388,0
55753,0,False,False,1477757101,1477757101,389,0
55754,0,False,False,1461859325,1461859325,390,0
55755,0,False,False,1464777744,1464777744,391,0
55756,0,False,False,1472478771,1472478771,392,0
55757,0,False,False,1452713457,1452713457,393,0
55758,0,False,False,1455298112,1455298112,394,0
55759,0,False,False,1479796934,1479796934,396,0
55760,0,False,False,1474293121,1474293121,397,0
55761,0,False,False,1480354273,1480354273,398,0
55762,0,False,False,1471359105,1471359105,399,0
55763,0,False,False,1464036365,1464036365,401,0
55764,0,False,False,1462423886,1462423886,404,0
55765,0,False,False,1454980509,1454980509,405,0
55766,0,False,False,1452030751,1452030751,407,0
55768,0,False,False,1465257352,1465257352,409,0
55769,0,False,False,1481429363,1481429363,410,0
55770,0,False,False,1469313289,1469313289,411,0
55771,0,False,False,1468809773,1468809773,413,0
55772,0,False,False,1466416898,1466416898,414,0
55773,0,False,False,1450319708,1450319708,417,0
55774,0,False,False,1474631645,1474631645,418,0
55775,0,False,False,1472207283,1472207283,419,0
55776,0,False,False,1449505341,1449505341,420,0
55777,0,False,False,1462241413,1462241413,421,0
55779,0,False,False,1449689892,1449689892,423,0
55780,0,False,False,1451775344,1451775344,424,0
55781,0,False,False,1477593221,1477593221,425,0
55782,0,False,False,1477593221,1477593221,426,0
55808,0,False,False,1449921950,1449921950,429,0
55810,0,False,False,1466477138,1466477138,431,0
55811,0,False,False,1476226430,1476226430,432,0
55812,0,False,False,1454632689,1454632689,435,0
55813,0,False,False,1456012652,1456012652,436,0
85226,0,False,False,1481130887,1481130887,438,0
85227,0,False,False,1460970260,1460970260,439,0
85228,0,False,False,1465770905,1465770905,440,0
85229,0,False,False,1463498797,1463498797,441,0
85230,0,False,False,1451758594,1451758594,443,0
85231,0,False,False,1458151785,1458151785,444,0
85232,0,False,False,1479338680,1479338680,445,0
85238,0,False,False,1466132441,1466132441,448,0
85239,0,False,False,1456257571,1456257571,449,0
85240,0,False,False,1478246747,1478246747,450,0
85241,0,False,False,1464718558,1464718558,451,0
85242,0,False,False,1472485343,1472485343,452,0
141290,0,False,False,1456570580,1456570580,454,0
141291,0,False,False,1458152873,1458152873,455,0
141469,0,False,False,1462986393,1462986393,457,0
141470,0,False,False,1469029239,1469029239,458,0
141471,0,False,False,1454010632,1454010632,459,0
141472,0,False,False,1476829226,1476829226,460,0
141473,0,False,False,1474310700,1474310700,463,0
141475,0,False,False,1470003609,1470003609,467,0
141476,0,False,False,1474301373,1474301373,468,0
141477,0,False,False,1462383464,1462383464,469,0
141478,0,False,False,1460565960,1460565960,470,0
141479,0,False,False,1475000142,1475000142,471,0
141480,0,False,False,1462830281,1462830281,472,0
141481,0,False,False,1470325959,1470325959,473,0
141482,0,False,False,1477526732,1477526732,474,0
141483,0,False,False,1456845768,1456845768,475,0
141484,0,False,False,1474731999,1474731999,476,0
141485,0,False,False,1466434403,1466434403,477,0
141486,0,False,False,1474744805,1474744805,478,0
141487,0,False,False,1450981303,1450981303,479,0
141488,0,False,False,1470295643,1470295643,480,0
141489,0,False,False,1470295643,1470295643,481,0
141490,0,False,False,1481193295,1481193295,483,0
141491,0,False,False,1460655657,1460655657,484,0
141492,0,False,False,1468822594,1468822594,485,0
141493,0,False,False,1462565343,1462565343,486,0
141494,0,False,False,1471520552,1471520552,487,0
141495,0,False,False,1455397206,1455397206,488,0
141496,0,False,False,1480512836,1480512836,489,0
141497,0,False,False,1450755464,1450755464,490,0
141498,0,False,False,1456854316,1456854316,491,0
141499,0,False,False,1451347190,1451347190,492,0
141500,0,False,False,1462885392,1462885392,493,0
141501,0,False,False,1474714495,1474714495,495,0
141506,0,False,False,1469053080,1469053080,497,0
141508,0,False,False,1462127719,1462127719,499,0
141511,0,False,False,1478375561,1478375561,503,0
141513,0,False,False,1453469719,1453469719,505,0
141514,0,False,False,1462798043,1462798043,506,0
141515,0,False,False,1454888923,1454888923,507,0
141516,0,False,False,1458138800,1458138800,508,0
141517,0,False,False,1464595607,1464595607,509,0
141518,0,False,False,1451368454,1451368454,510,0
141519,0,False,False,1449512205,1449512205,511,0
141520,0,False,False,1462204109,1462204109,512,0
141521,0,False,False,1461828141,1461828141,515,0
141527,0,False,False,1472013547,1472013547,517,0
141528,0,False,False,1472338989,1472338989,518,0
141529,0,False,False,1471396676,1471396676,519,0
141530,0,False,False,1459296168,1459296168,520,0
141531,0,False,False,1467784503,1467784503,522,0
141532,0,False,False,1449150719,1449150719,523,0
141553,0,False,False,1452050710,1452050710,525,0
141554,0,False,False,1462038147,1462038147,526,0
141555,0,False,False,1479397503,1479397503,528,0
141907,0,False,False,1474482365,1474482365,531,0
141908,0,False,False,1467321867,1467321867,532,0
141938,0,False,False,1456446728,1456446728,535,0
141940,0,False,False,1470379569,1470379569,537,0
141941,0,False,False,1480934816,1480934816,538,0
141942,0,False,False,1478854762,1478854762,540,0
141943,0,False,False,1464325578,1464325578,541,0
141944,0,False,False,1453769148,1453769148,542,0
141945,0,False,False,1456544774,1456544774,543,0
141946,0,False,False,1452647427,1452647427,544,0
141947,0,False,False,1473819749,1473819749,545,0
141948,0,False,False,1465233079,1465233079,546,0
141949,0,False,False,1469920707,1469920707,547,0
141950,0,False,False,1473878461,1473878461,548,0
141951,0,False,False,1471971310,1471971310,549,0
141954,0,False,False,1472600344,1472600344,551,0
141955,0,False,False,1455131111,1455131111,553,0
141956,0,False,False,1473367691,1473367691,555,0
141982,0,False,False,1465269688,1465269688,557,0
141983,0,False,False,1455044315,1455044315,558,0
141984,0,False,False,1479929339,1479929339,559,0
141985,0,False,False,1450561414,1450561414,561,0
141998,0,False,False,1477590157,1477590157,563,0
141999,0,False,False,1464632265,1464632265,566,0
142000,0,False,False,1466803258,1466803258,567,0
142001,0,False,False,1468894945,1468894945,568,0
142002,0,False,False,1466527248,1466527248,569,0
142003,0,False,False,1478830936,1478830936,570,0
142004,0,False,False,1478830936,1478830936,571,0
142005,0,False,False,1467671646,1467671646,572,0
142006,0,False,False,1477977618,1477977618,573,0
142007,0,False,False,1473713137,1473713137,574,0
142009,0,False,False,1463779821,1463779821,576,0
142010,0,False,False,1458927760,1458927760,578,0
142011,0,False,False,1472396566,1472396566,579,0
142012,0,False,False,1456518371,1456518371,580,0
142013,0,False,False,1467843440,1467843440,581,0
142014,0,False,False,1466214604,1466214604,582,0
142015,0,False,False,1455648701,1455648701,583,0
142016,0,False,False,1471092973,1471092973,584,0
142017,0,False,False,1478638803,1478638803,586,0
142018,0,False,False,1469000250,1469000250,587,0
142020,0,False,False,1456238106,1456238106,589,0
142900,0,False,False,1451159586,1451159586,591,0
142901,0,False,False,1470294033,1470294033,592,0
142902,0,False,False,1470294033,1470294033,593,0
142903,0,False,False,1466572637,1466572637,594,0
142904,0,False,False,1473697050,1473697050,595,0
142905,0,False,False,1482265400,1482265400,596,0
142906,0,False,False,1452111889,1452111889,597,0
142907,0,False,False,1477439795,1477439795,598,0
142908,0,False,False,1477136880,1477136880,599,0
142909,0,False,False,1479733780,1479733780,600,0
142913,0,False,False,1455367517,1455367517,602,0
142914,0,False,False,1470731446,1470731446,603,0
142915,0,False,False,1470731446,1470731446,604,0
142916,0,False,False,1470729984,1470729984,605,0
142917,0,False,False,1470729984,1470729984,606,0
142918,0,False,False,1463882951,1463882951,607,0
142919,0,False,False,1474451264,1474451264,608,0
142920,0,False,False,1449951822,1449951822,609,0
142921,0,False,False,1467010868,1467010868,610,0
142922,0,False,False,1473553562,1473553562,611,0
142930,0,False,False,1480810888,1480810888,613,0
142931,0,False,False,1477945375,1477945375,614,0
142932,0,False,False,1449551539,1449551539,615,0
142933,0,False,False,1482799641,1482799641,616,0
215992,0,False,False,1451952280,1451952280,618,0
215994,0,False,False,1453435876,1453435876,620,0
215995,0,False,False,1461098644,1461098644,621,0
215996,0,False,False,1451676280,1451676280,624,0
216002,0,False,False,1472564888,1472564888,626,0
216003,0,False,False,1473189048,1473189048,627,0
216004,0,False,False,1467818201,1467818201,628,0
216006,0,False,False,1460151614,1460151614,630,0
216007,0,False,False,1468123352,1468123352,631,0
216008,0,False,False,1456288616,1456288616,633,0
216009,0,False,False,1463542009,1463542009,634,0
216010,0,False,False,1450986011,1450986011,635,0
216011,0,False,False,1460651184,1460651184,636,0
216012,0,False,False,1449614843,1449614843,637,0
216013,0,False,False,1459934303,1459934303,638,0
216015,0,False,False,1468929381,1468929381,640,0
216016,0,False,False,1465918874,1465918874,641,0
216017,0,False,False,1475658005,1475658005,642,0
216018,0,False,False,1471359280,1471359280,643,0
216019,0,False,False,1473263162,1473263162,644,0
216087,0,False,False,1474301210,1474301210,646,0
216088,0,False,False,1474357827,1474357827,647,0
216089,0,False,False,1474357827,1474357827,648,0
216090,0,False,False,1474906808,1474906808,649,0
216098,0,False,False,1454949854,1454949854,651,0
216099,0,False,False,1474233320,1474233320,652,0
216100,0,False,False,1457368352,1457368352,653,0
216101,0,False,False,1479701350,1479701350,654,0
216102,0,False,False,1461812959,1461812959,655,0
216106,0,False,False,1469142253,1469142253,658,0
216107,0,False,False,1454675735,1454675735,659,0
216117,0,False,False,1462284103,1462284103,661,0
216118,0,False,False,1469734335,1469734335,662,0
216125,0,False,False,1463258002,1463258002,664,0
216126,0,False,False,1474981023,1474981023,665,0
216127,0,False,False,1454337481,1454337481,666,0
216128,0,False,False,1478975512,1478975512,667,0
216129,0,False,False,1468192080,1468192080,668,0
216130,0,False,False,1454947291,1454947291,669,0
216131,0,False,False,1461273806,1461273806,670,0
216132,0,False,False,1452551198,1452551198,671,0
216133,0,False,False,1468500027,1468500027,672,0
216134,0,False,False,1455288982,1455288982,673,0
216145,0,False,False,1453820231,1453820231,675,0
216146,0,False,False,1474157851,1474157851,676,0
216147,0,False,False,1474157851,1474157851,677,0
216155,0,False,False,1457952429,1457952429,683,0
216156,0,False,False,1474667066,1474667066,685,0
216170,0,False,False,1455135714,1455135714,688,0
216171,0,False,False,1468272854,1468272854,689,0
216172,0,False,False,1452366791,1452366791,690,0
216173,0,False,False,1481842135,1481842135,691,0
216174,0,False,False,1473453424,1473453424,692,0
216175,0,False,False,1477662022,1477662022,693,0
216176,0,False,False,1477231499,1477231499,695,0
216177,0,False,False,1475414078,1475414078,696,0
216178,0,False,False,1476529047,1476529047,697,0
216179,0,False,False,1475414161,1475414161,698,0
216180,0,False,False,1459478138,1459478138,700,0
216181,0,False,False,1477122086,1477122086,701,0
216182,0,False,False,1472108811,1472108811,702,0
216183,0,False,False,1461214603,1461214603,703,0
216184,0,False,False,1457716963,1457716963,704,0
216185,0,False,False,1460059384,1460059384,705,0
216186,0,False,False,1477344408,1477344408,707,0
216187,0,False,False,1460162273,1460162273,708,0
216188,0,False,False,1469366962,1469366962,709,0
216189,0,False,False,1457466435,1457466435,710,0
216281,0,False,False,1472961143,1472961143,712,0
216289,0,False,False,1458248314,1458248314,714,0
216290,0,False,False,1455435249,1455435249,715,0
216291,0,False,False,1451748898,1451748898,716,0
216292,0,False,False,1467841632,1467841632,717,0
216293,0,False,False,1454179746,1454179746,718,0
216294,0,False,False,1461697995,1461697995,719,0
216295,0,False,False,1483061731,1483061731,720,0
216296,0,False,False,1467130110,1467130110,721,0
216297,0,False,False,1482097607,1482097607,723,0
216298,0,False,False,1462523483,1462523483,724,0
216299,0,False,False,1462523483,1462523483,725,0
216300,0,False,False,1451390266,1451390266,727,0
216301,0,False,False,1477928394,1477928394,728,0
216302,0,False,False,1472503532,1472503532,729,0
216303,0,False,False,1468949603,1468949603,730,0
216304,0,False,False,1451878746,1451878746,731,0
216305,0,False,False,1474063442,1474063442,732,0
216306,0,False,False,1474063442,1474063442,733,0
216422,0,False,False,1451431874,1451431874,735,0
216423,0,False,False,1477875768,1477875768,736,0
216424,0,False,False,1458534284,1458534284,737,0
216425,0,False,False,1478704990,1478704990,738,0
216426,0,False,False,1482572972,1482572972,739,0
216427,0,False,False,1455645554,1455645554,740,0
216428,0,False,False,1471803959,1471803959,741,0
216448,0,False,False,1471994850,1471994850,743,0
216449,0,False,False,1457524833,1457524833,744,0
216450,0,False,False,1474124882,1474124882,745,0
216451,0,False,False,1467281596,1467281596,746,0
216454,0,False,False,1461867810,1461867810,748,0
216455,0,False,False,1473281816,1473281816,749,0
216456,0,False,False,1454437098,1454437098,750,0
216457,0,False,False,1457058140,1457058140,751,0
216462,0,False,False,1464657609,1464657609,753,0
216464,0,False,False,1463029689,1463029689,756,0
216465,0,False,False,1478114235,1478114235,758,0
216480,0,False,False,1480542720,1480542720,760,0
216481,0,False,False,1471478674,1471478674,761,0
216482,0,False,False,1462209230,1462209230,762,0
216483,0,False,False,1461980508,1461980508,763,0
216484,0,False,False,1451999204,1451999204,764,0
216485,0,False,False,1463871870,1463871870,765,0
216486,0,False,False,1467903457,1467903457,766,0
216487,0,False,False,1467784638,1467784638,767,0
216527,0,False,False,1462362301,1462362301,769,0
216528,0,False,False,1477784300,1477784300,770,0
216549,0,False,False,1456034226,1456034226,772,0
216550,0,False,False,1463748228,1463748228,773,0
216551,0,False,False,1459102616,1459102616,774,0
216552,0,False,False,1452799413,1452799413,775,0
216555,0,False,False,1475186672,1475186672,777,0
216568,0,False,False,1468248040,1468248040,780,0
216569,0,False,False,1470295893,1470295893,781,0
216570,0,False,False,1470295893,1470295893,782,0
216571,0,False,False,1478476494,1478476494,783,0
216572,0,False,False,1482878812,1482878812,784,0
216578,0,False,False,1453106012,1453106012,786,0
216587,0,False,False,1483232096,1483232096,789,0
216598,0,False,False,1472240383,1472240383,793,0
216601,0,False,False,1467050670,1467050670,795,0
216602,0,False,False,1449186173,1449186173,796,0
216603,0,False,False,1457007806,1457007806,797,0
216604,0,False,False,1450716347,1450716347,799,0
216605,0,False,False,1469212639,1469212639,800,0
216606,0,False,False,1450656578,1450656578,801,0
216607,0,False,False,1454943451,1454943451,802,0
216608,0,False,False,1468900940,1468900940,803,0
216609,0,False,False,1467819584,1467819584,804,0
216610,0,False,False,1483107429,1483107429,805,0
216611,0,False,False,1460966858,1460966858,806,0
216612,0,False,False,1456433071,1456433071,807,0
216614,0,False,False,1470304483,1470304483,809,0
216714,0,False,False,1478887466,1478887466,813,0
216715,0,False,False,1474241166,1474241166,814,0
216716,0,False,False,1448932297,1448932297,815,0
216717,0,False,False,1452810113,1452810113,818,0
216718,0,False,False,1468984924,1468984924,819,0
216719,0,False,False,1475767746,1475767746,820,0
216808,0,False,False,1458586241,1458586241,822,0
216809,0,False,False,1466044745,1466044745,824,0
216810,0,False,False,1457903337,1457903337,825,0
216811,0,False,False,1466617374,1466617374,826,0
216814,0,False,False,1456626680,1456626680,829,0
216815,0,False,False,1469733174,1469733174,830,0
216816,0,False,False,1471986601,1471986601,831,0
216817,0,False,False,1450631213,1450631213,832,0
216818,0,False,False,1470566955,1470566955,833,0
216819,0,False,False,1451330155,1451330155,834,0
216820,0,False,False,1453049991,1453049991,835,0
216821,0,False,False,1471792760,1471792760,838,0
216822,0,False,False,1459961379,1459961379,839,0
216823,0,False,False,1452431720,1452431720,840,0
216824,0,False,False,1454249793,1454249793,841,0
216825,0,False,False,1462844330,1462844330,842,0
216826,0,False,False,1450379872,1450379872,843,0
216827,0,False,False,1461228940,1461228940,844,0
216828,0,False,False,1479833282,1479833282,846,0
216829,0,False,False,1465590677,1465590677,847,0
216830,0,False,False,1460790275,1460790275,848,0
216838,0,False,False,1456811195,1456811195,850,0
216842,0,False,False,1456563541,1456563541,852,0
216843,0,False,False,1473042168,1473042168,853,0
216844,0,False,False,1481573036,1481573036,854,0
216845,0,False,False,1470255544,1470255544,855,0
216846,0,False,False,1462883844,1462883844,856,0
216847,0,False,False,1482338721,1482338721,857,0
216848,0,False,False,1460280104,1460280104,858,0
216849,0,False,False,1474358437,1474358437,859,0
216850,0,False,False,1474358437,1474358437,860,0
216867,0,False,False,1464529429,1464529429,862,0
216868,0,False,False,1460759543,1460759543,863,0
216869,0,False,False,1456286701,1456286701,864,0
216870,0,False,False,1450754171,1450754171,865,0
216871,0,False,False,1478102222,1478102222,866,0
216872,0,False,False,1477084476,1477084476,867,0
216873,0,False,False,1467058588,1467058588,868,0
216874,0,False,False,1450237225,1450237225,869,0
216879,0,False,False,1474993013,1474993013,872,0
216880,0,False,False,1452057647,1452057647,873,0
216881,0,False,False,1460040880,1460040880,874,0
216892,0,False,False,1462193712,1462193712,876,0
216893,0,False,False,1475597492,1475597492,877,0
216894,0,False,False,1460576040,1460576040,878,0
216897,0,False,False,1472587350,1472587350,880,0
216898,0,False,False,1470349586,1470349586,882,0
216899,0,False,False,1470349586,1470349586,883,0
216900,0,False,False,1478712372,1478712372,884,0
216901,0,False,False,1472065672,1472065672,885,0
216902,0,False,False,1452185911,1452185911,886,0
216903,0,False,False,1458719679,1458719679,887,0
216907,0,False,False,1467645881,1467645881,889,0
216908,0,False,False,1469413611,1469413611,890,0
216910,0,False,False,1473247680,1473247680,892,0
216911,0,False,False,1472429300,1472429300,895,0
216912,0,False,False,1450009850,1450009850,896,0
216913,0,False,False,1471568535,1471568535,897,0
216914,0,False,False,1470584279,1470584279,898,0
216915,0,False,False,1475768999,1475768999,899,0
216916,0,False,False,1450382275,1450382275,900,0
216917,0,False,False,1462436442,1462436442,901,0
216925,0,False,False,1469500817,1469500817,903,0
216926,0,False,False,1474288017,1474288017,904,0
216927,0,False,False,1463327941,1463327941,906,0
216928,0,False,False,1453844237,1453844237,907,0
216930,0,False,False,1472641071,1472641071,909,0
216931,0,False,False,1454000630,1454000630,910,0
216932,0,False,False,1454000630,1454000630,911,0
216935,0,False,False,1472197479,1472197479,913,0
216936,0,False,False,1462069896,1462069896,914,0
216937,0,False,False,1477096939,1477096939,915,0
216938,0,False,False,1455891299,1455891299,916,0
216939,0,False,False,1449297717,1449297717,917,0
216940,0,False,False,1453733636,1453733636,918,0
216941,0,False,False,1483177168,1483177168,919,0
216942,0,False,False,1475137296,1475137296,920,0
216943,0,False,False,1475137296,1475137296,921,0
216944,0,False,False,1451506064,1451506064,922,0
216945,0,False,False,1461332997,1461332997,923,0
216946,0,False,False,1475775893,1475775893,924,0
216947,0,False,False,1477255565,1477255565,925,0
216948,0,False,False,1452205524,1452205524,926,0
216950,0,False,False,1452194218,1452194218,928,0
216951,0,False,False,1454875546,1454875546,929,0
216952,0,False,False,1456261918,1456261918,930,0
216953,0,False,False,1458831274,1458831274,932,0
216954,0,False,False,1466906264,1466906264,933,0
216955,0,False,False,1470721720,1470721720,934,0
216956,0,False,False,1470721720,1470721720,935,0
216957,0,False,False,1455166856,1455166856,936,0
216958,0,False,False,1449882172,1449882172,937,0
216959,0,False,False,1452429681,1452429681,939,0
216960,0,False,False,1460677773,1460677773,940,0
216961,0,False,False,1482914186,1482914186,941,0
216962,0,False,False,1459967188,1459967188,943,0
216963,0,False,False,1455520968,1455520968,945,0
216964,0,False,False,1455520968,1455520968,946,0
216975,0,False,False,1451407354,1451407354,949,0
217028,0,False,False,1458600631,1458600631,952,0
217029,0,False,False,1457362372,1457362372,953,0
217030,0,False,False,1471492504,1471492504,954,0
217031,0,False,False,1472927708,1472927708,956,0
217032,0,False,False,1470939505,1470939505,957,0
217033,0,False,False,1451857929,1451857929,958,0
217034,0,False,False,1483376637,1483376637,959,0
217038,0,False,False,1449542408,1449542408,961,0
217040,0,False,False,1477854775,1477854775,964,0
217041,0,False,False,1454951006,1454951006,965,0
217042,0,False,False,1479472572,1479472572,966,0
217043,0,False,False,1470938780,1470938780,968,0
217044,0,False,False,1455465891,1455465891,969,0
217045,0,False,False,1449627887,1449627887,970,0
218330,0,False,False,1455299934,1455299934,972,0
218331,0,False,False,1457128164,1457128164,973,0
218332,0,False,False,1457128164,1457128164,974,0
218333,0,False,False,1480916281,1480916281,975,0
218339,0,False,False,1457701648,1457701648,977,0
218340,0,False,False,1481920121,1481920121,978,0
218341,0,False,False,1453576134,1453576134,979,0
218342,0,False,False,1476846387,1476846387,980,0
218343,0,False,False,1482951882,1482951882,981,0
218344,0,False,False,1450131089,1450131089,982,0
218345,0,False,False,1455899575,1455899575,983,0
218346,0,False,False,1465372399,1465372399,984,0
218347,0,False,False,1457123380,1457123380,985,0
218349,0,False,False,1458504067,1458504067,987,0
218350,0,False,False,1469652006,1469652006,988,0
218351,0,False,False,1469652006,1469652006,989,0
218352,0,False,False,1482444624,1482444624,990,0
218353,0,False,False,1476719180,1476719180,991,0
218354,0,False,False,1482429279,1482429279,992,0
218355,0,False,False,1470291175,1470291175,993,0
218356,0,False,False,1481304207,1481304207,994,0
218357,0,False,False,1449682975,1449682975,996,0
218358,0,False,False,1464362981,1464362981,997,0
218359,0,False,False,1467203378,1467203378,998,0
218360,0,False,False,1459304786,1459304786,1000,0
218361,0,False,False,1469999156,1469999156,1001,0
218362,0,False,False,1475286016,1475286016,1002,0
218363,0,False,False,1464291350,1464291350,1003,0
218366,0,False,False,1449864029,1449864029,1008,0
218367,0,False,False,1460358894,1460358894,1009,0
218368,0,False,False,1471289112,1471289112,1010,0
218369,0,False,False,1459914088,1459914088,1013,0
218370,0,False,False,1457911532,1457911532,1014,0
218371,0,False,False,1465766330,1465766330,1015,0
218372,0,False,False,1464787898,1464787898,1016,0
218373,0,False,False,1476736666,1476736666,1017,0
218375,0,False,False,1471136596,1471136596,1020,0
218379,0,False,False,1458397612,1458397612,1024,0
218380,0,False,False,1462261923,1462261923,1025,0
218483,0,False,False,1470893385,1470893385,1027,0
218484,0,False,False,1470893385,1470893385,1028,0
218485,0,False,False,1474644705,1474644705,1029,0
218486,0,False,False,1453803680,1453803680,1031,0
218487,0,False,False,1453772517,1453772517,1032,0
218488,0,False,False,1453335792,1453335792,1033,0
218489,0,False,False,1464329019,1464329019,1034,0
218490,0,False,False,1473008772,1473008772,1035,0
281479,0,False,False,1466687734,1466687734,1038,0
281489,0,False,False,1463416274,1463416274,1040,0
281490,0,False,False,1454044882,1454044882,1041,0
281491,0,False,False,1469900073,1469900073,1043,0
281492,0,False,False,1471341802,1471341802,1044,0
281493,0,False,False,1449700268,1449700268,1046,0
281494,0,False,False,1466643202,1466643202,1047,0
281495,0,False,False,1481412216,1481412216,1048,0
281496,0,False,False,1479475678,1479475678,1049,0
281497,0,False,False,1455892378,1455892378,1050,0
281498,0,False,False,1469707369,1469707369,1051,0
281499,0,False,False,1457741908,1457741908,1052,0
281500,0,False,False,1460059240,1460059240,1054,0
281501,0,False,False,1478643352,1478643352,1055,0
281517,0,False,False,1468297697,1468297697,1059,0
281518,0,False,False,1471562805,1471562805,1062,0
281519,0,False,False,1468787674,1468787674,1063,0
281520,0,False,False,1451247808,1451247808,1064,0
281574,0,False,False,1462977004,1462977004,1066,0
281575,0,False,False,1474324991,1474324991,1067,0
283525,0,False,False,1471158921,1471158921,1070,0
283526,0,False,False,1471158921,1471158921,1071,0
283540,0,False,False,1453511673,1453511673,1076,0
283541,0,False,False,1463343305,1463343305,1077,0
283542,0,False,False,1449463206,1449463206,1078,0
283543,0,False,False,1478924328,1478924328,1079,0
283546,0,False,False,1452468202,1452468202,1081,0
283547,0,False,False,1452468202,1452468202,1082,0
283548,0,False,False,1464851317,1464851317,1083,0
283549,0,False,False,1455136533,1455136533,1086,0
283550,0,False,False,1450196482,1450196482,1087,0
283551,0,False,False,1473219688,1473219688,1088,0
283552,0,False,False,1455287837,1455287837,1089,0
283553,0,False,False,1465488115,1465488115,1090,0
283554,0,False,False,1481220393,1481220393,1091,0
283555,0,False,False,1464724572,1464724572,1092,0
283557,0,False,False,1480954894,1480954894,1096,0
283558,0,False,False,1470037918,1470037918,1097,0
283563,0,False,False,1455064600,1455064600,1100,0
283564,0,False,False,1478822302,1478822302,1102,0
283572,0,False,False,1464565750,1464565750,1106,0
283573,0,False,False,1459210686,1459210686,1107,0
283574,0,False,False,1463455667,1463455667,1108,0
283575,0,False,False,1478385618,1478385618,1109,0
283576,0,False,False,1466102300,1466102300,1110,0
284351,0,False,False,1460834446,1460834446,1113,0
284352,0,False,False,1460489546,1460489546,1114,0
284354,0,False,False,1453155127,1453155127,1116,0
284355,0,False,False,1457714619,1457714619,1117,0
284628,0,False,False,1461637586,1461637586,1119,0
284629,0,False,False,1462018161,1462018161,1120,0
284630,0,False,False,1455766192,1455766192,1121,0
284631,0,False,False,1450587781,1450587781,1123,0
284632,0,False,False,1452545680,1452545680,1125,0
284633,0,False,False,1473290261,1473290261,1126,0
284634,0,False,False,1483109764,1483109764,1127,0
284635,0,False,False,1468341446,1468341446,1128,0
284636,0,False,False,1470614309,1470614309,1129,0
284637,0,False,False,1470614309,1470614309,1130,0
284638,0,False,False,1449551569,1449551569,1131,0
284639,0,False,False,1467043088,1467043088,1133,0
284640,0,False,False,1461093676,1461093676,1134,0
284641,0,False,False,1475187905,1475187905,1135,0
284642,0,False,False,1453316212,1453316212,1136,0
284643,0,False,False,1470841746,1470841746,1137,0
284644,0,False,False,1454336538,1454336538,1139,0
284645,0,False,False,1462307455,1462307455,1140,0
284647,0,False,False,1474404134,1474404134,1142,0
284648,0,False,False,1474404134,1474404134,1143,0
284649,0,False,False,1458439322,1458439322,1144,0
284650,0,False,False,1471125641,1471125641,1145,0
284651,0,False,False,1460231784,1460231784,1146,0
284652,0,False,False,1471698144,1471698144,1147,0
284653,0,False,False,1462527473,1462527473,1148,0
284654,0,False,False,1478879682,1478879682,1149,0
284655,0,False,False,1472007160,1472007160,1150,0
284660,0,False,False,1469050241,1469050241,1154,0
284661,0,False,False,1473805544,1473805544,1155,0
284662,0,False,False,1464226263,1464226263,1156,0
284663,0,False,False,1459372559,1459372559,1157,0
284664,0,False,False,1465117310,1465117310,1160,0
284665,0,False,False,1456969551,1456969551,1161,0
284668,0,False,False,1472088689,1472088689,1163,0
284669,0,False,False,1451875035,1451875035,1164,0
284670,0,False,False,1449930892,1449930892,1165,0
284671,0,False,False,1459934141,1459934141,1166,0
284672,0,False,False,1475700596,1475700596,1167,0
284673,0,False,False,1475700596,1475700596,1168,0
284684,0,False,False,1458859419,1458859419,1173,0
284685,0,False,False,1453514489,1453514489,1174,0
284686,0,False,False,1465152344,1465152344,1175,0
284687,0,False,False,1470299921,1470299921,1176,0
284689,0,False,False,1453812714,1453812714,1178,0
284690,0,False,False,1467904795,1467904795,1179,0
284691,0,False,False,1467032178,1467032178,1180,0
284692,0,False,False,1471734099,1471734099,1181,0
284693,0,False,False,1458185763,1458185763,1182,0
284694,0,False,False,1451580723,1451580723,1183,0
284695,0,False,False,1469375818,1469375818,1184,0
284696,0,False,False,1471608392,1471608392,1186,0
284697,0,False,False,1455492766,1455492766,1187,0
284701,0,False,False,1472296678,1472296678,1189,0
284709,0,False,False,1450506773,1450506773,1192,0
284710,0,False,False,1450506785,1450506785,1193,0
284711,0,False,False,1450507436,1450507436,1194,0
284712,0,False,False,1456176178,1456176178,1195,0
284713,0,False,False,1468744480,1468744480,1196,0
284714,0,False,False,1475234930,1475234930,1197,0
284715,0,False,False,1468267019,1468267019,1198,0
284716,0,False,False,1456780366,1456780366,1199,0
284717,0,False,False,1456780366,1456780366,1200,0
284718,0,False,False,1455593544,1455593544,1201,0
284719,0,False,False,1471728252,1471728252,1202,0
284720,0,False,False,1472396448,1472396448,1203,0
284721,0,False,False,1465677355,1465677355,1204,0
284722,0,False,False,1465327000,1465327000,1206,0
284723,0,False,False,1468336101,1468336101,1208,0
284724,0,False,False,1464722920,1464722920,1209,0
284728,0,False,False,1457225379,1457225379,1212,0
284729,0,False,False,1464138737,1464138737,1214,0
284963,0,False,False,1469614445,1469614445,1216,0
284964,0,False,False,1450289815,1450289815,1217,0
285015,0,False,False,1466000197,1466000197,1219,0
285042,0,False,False,1471219619,1471219619,1222,0
285043,0,False,False,1478533210,1478533210,1224,0
285044,0,False,False,1457297177,1457297177,1225,0
285045,0,False,False,1452067373,1452067373,1226,0
285046,0,False,False,1478814308,1478814308,1227,0
285047,0,False,False,1457823504,1457823504,1228,0
285048,0,False,False,1449915817,1449915817,1229,0
285049,0,False,False,1462733680,1462733680,1230,0
285050,0,False,False,1461622489,1461622489,1231,0
285051,0,False,False,1470767988,1470767988,1232,0
285052,0,False,False,1478643409,1478643409,1233,0
285053,0,False,False,1480964855,1480964855,1234,0
285054,0,False,False,1474378165,1474378165,1235,0
285055,0,False,False,1471462933,1471462933,1236,0
285056,0,False,False,1452231882,1452231882,1237,0
285057,0,False,False,1478925571,1478925571,1239,0
285058,0,False,False,1448986560,1448986560,1240,0
285059,0,False,False,1459769266,1459769266,1241,0
285063,0,False,False,1454457944,1454457944,1243,0
285064,0,False,False,1471357463,1471357463,1244,0
285065,0,False,False,1465568724,1465568724,1246,0
285071,0,False,False,1473850160,1473850160,1248,0
285072,0,False,False,1464014708,1464014708,1249,0
285073,0,False,False,1469214130,1469214130,1250,0
285074,0,False,False,1469650372,1469650372,1251,0
285075,0,False,False,1472464752,1472464752,1253,0
285076,0,False,False,1465500914,1465500914,1254,0
285077,0,False,False,1452273746,1452273746,1256,0
285078,0,False,False,1473599169,1473599169,1257,0
285079,0,False,False,1482960984,1482960984,1258,0
285080,0,False,False,1456450486,1456450486,1261,0
285081,0,False,False,1471370402,1471370402,1262,0
285082,0,False,False,1482954292,1482954292,1265,0
285156,0,False,False,1453338174,1453338174,1267,0
285157,0,False,False,1478506914,1478506914,1268,0
285158,0,False,False,1475535739,1475535739,1269,0
285159,0,False,False,1470667961,1470667961,1270,0
285160,0,False,False,1452045353,1452045353,1271,0
285161,0,False,False,1455740502,1455740502,1272,0
285177,0,False,False,1464139340,1464139340,1276,0
285178,0,False,False,1469924447,1469924447,1277,0
285179,0,False,False,1458973085,1458973085,1278,0
285180,0,False,False,1450043396,1450043396,1280,0
285181,0,False,False,1468419384,1468419384,1281,0
285182,0,False,False,1475200006,1475200006,1282,0
285183,0,False,False,1452445852,1452445852,1284,0
285238,0,False,False,1470683245,1470683245,1286,0
285239,0,False,False,1455248406,1455248406,1287,0
285242,0,False,False,1462397738,1462397738,1289,0
285243,0,False,False,1464417534,1464417534,1290,0
285244,0,False,False,1476687494,1476687494,1291,0
285245,0,False,False,1469284188,1469284188,1292,0
285246,0,False,False,1468245348,1468245348,1293,0
285247,0,False,False,1467654125,1467654125,1294,0
285248,0,False,False,1478389085,1478389085,1295,0
285249,0,False,False,1472158922,1472158922,1296,0
285250,0,False,False,1458704435,1458704435,1297,0
285251,0,False,False,1459356053,1459356053,1298,0
285266,0,False,False,1451983390,1451983390,1301,0
285267,0,False,False,1466285714,1466285714,1302,0
285268,0,False,False,1466285714,1466285714,1303,0
285269,0,False,False,1481607881,1481607881,1304,0
285270,0,False,False,1459690486,1459690486,1305,0
285272,0,False,False,1452697172,1452697172,1307,0
285273,0,False,False,1471488760,1471488760,1308,0
285274,0,False,False,1449682302,1449682302,1309,0
285275,0,False,False,1472487658,1472487658,1310,0
285276,0,False,False,1460730138,1460730138,1311,0
285277,0,False,False,1449843309,1449843309,1312,0
285278,0,False,False,1452297432,1452297432,1314,0
285279,0,False,False,1478458981,1478458981,1315,0
285280,0,False,False,1455283455,1455283455,1316,0
285281,0,False,False,1480832777,1480832777,1317,0
285282,0,False,False,1451367282,1451367282,1318,0
285283,0,False,False,1478502419,1478502419,1319,0
285284,0,False,False,1471885819,1471885819,1320,0
285711,0,False,False,1454786022,1454786022,1324,0
285712,0,False,False,1479236544,1479236544,1325,0
285713,0,False,False,1463095844,1463095844,1326,0
285836,0,False,False,1461875947,1461875947,1329,0
285891,0,False,False,1453142428,1453142428,1331,0
285892,0,False,False,1457455361,1457455361,1332,0
285893,0,False,False,1458143100,1458143100,1334,0
285894,0,False,False,1476277614,1476277614,1335,0
285895,0,False,False,1474636326,1474636326,1336,0
285896,0,False,False,1464757617,1464757617,1338,0
285897,0,False,False,1470350282,1470350282,1339,0
285898,0,False,False,1470350282,1470350282,1340,0
285899,0,False,False,1460064512,1460064512,1341,0
285900,0,False,False,1466997541,1466997541,1342,0
285901,0,False,False,1472909097,1472909097,1343,0
286781,0,False,False,1471413319,1471413319,1345,0
286782,0,False,False,1467281794,1467281794,1346,0
286783,0,False,False,1462553215,1462553215,1347,0
286784,0,False,False,1480363030,1480363030,1348,0
286787,0,False,False,1451950369,1451950369,1351,0
286817,0,False,False,1458825765,1458825765,1354,0
286818,0,False,False,1466485518,1466485518,1355,0
286819,0,False,False,1482953157,1482953157,1356,0
286820,0,False,False,1463524706,1463524706,1358,0
286821,0,False,False,1476693314,1476693314,1359,0
286822,0,False,False,1468903240,1468903240,1361,0
286823,0,False,False,1481412686,1481412686,1362,0
286824,0,False,False,1472671890,1472671890,1363,0
286825,0,False,False,1458605073,1458605073,1364,0
286826,0,False,False,1475149693,1475149693,1366,0
286827,0,False,False,1464823902,1464823902,1368,0
286828,0,False,False,1470023501,1470023501,1370,0
286829,0,False,False,1460045237,1460045237,1371,0
286888,0,False,False,1468861761,1468861761,1373,0
286889,0,False,False,1465060046,1465060046,1374,0
286890,0,False,False,1472005399,1472005399,1375,0
286891,0,False,False,1465415614,1465415614,1376,0
286892,0,False,False,1478933241,1478933241,1377,0
286893,0,False,False,1460988653,1460988653,1378,0
286894,0,False,False,1468446649,1468446649,1379,0
286895,0,False,False,1451893000,1451893000,1380,0
286896,0,False,False,1451689972,1451689972,1381,0
286899,0,False,False,1454660424,1454660424,1383,0
286900,0,False,False,1472523276,1472523276,1384,0
286901,0,False,False,1452195295,1452195295,1385,0
286902,0,False,False,1461444737,1461444737,1386,0
286903,0,False,False,1452457183,1452457183,1387,0
286904,0,False,False,1460043709,1460043709,1388,0
286905,0,False,False,1480542944,1480542944,1389,0
286906,0,False,False,1449672233,1449672233,1390,0
286907,0,False,False,1465476355,1465476355,1391,0
286910,0,False,False,1452862714,1452862714,1394,0
286911,0,False,False,1472115948,1472115948,1395,0
286912,0,False,False,1475272489,1475272489,1396,0
286913,0,False,False,1467792529,1467792529,1397,0
286916,0,False,False,1466445607,1466445607,1399,0
286917,0,False,False,1454905836,1454905836,1400,0
286918,0,False,False,1463414890,1463414890,1401,0
286919,0,False,False,1454595439,1454595439,1402,0
286996,0,False,False,1477416265,1477416265,1405,0
286997,0,False,False,1476723434,1476723434,1406,0
286998,0,False,False,1461140251,1461140251,1407,0
286999,0,False,False,1449846074,1449846074,1408,0
287000,0,False,False,1476713006,1476713006,1409,0
287001,0,False,False,1450993309,1450993309,1410,0
287016,0,False,False,1475357318,1475357318,1413,0
287017,0,False,False,1482867437,1482867437,1414,0
287066,0,False,False,1460950981,1460950981,1417,0
287095,0,False,False,1467936655,1467936655,1420,0
287096,0,False,False,1460792754,1460792754,1422,0
287097,0,False,False,1464981889,1464981889,1423,0
287098,0,False,False,1454034001,1454034001,1424,0
287099,0,False,False,1472675019,1472675019,1425,0
287100,0,False,False,1463458558,1463458558,1426,0
287101,0,False,False,1481430941,1481430941,1427,0
287102,0,False,False,1467302853,1467302853,1428,0
287103,0,False,False,1468937624,1468937624,1429,0
287104,0,False,False,1454122959,1454122959,1432,0
287105,0,False,False,1454122959,1454122959,1433,0
287106,0,False,False,1478336982,1478336982,1434,0
287107,0,False,False,1458886422,1458886422,1435,0
287110,0,False,False,1456235519,1456235519,1437,0
287111,0,False,False,1455758958,1455758958,1438,0
287112,0,False,False,1477577771,1477577771,1439,0
287113,0,False,False,1466775326,1466775326,1440,0
287114,0,False,False,1475908471,1475908471,1441,0
287115,0,False,False,1478394375,1478394375,1442,0
287116,0,False,False,1465568313,1465568313,1443,0
287117,0,False,False,1450662120,1450662120,1444,0
287216,0,False,False,1472016610,1472016610,1446,0
287267,0,False,False,1452563266,1452563266,1449,0
287268,0,False,False,1470447508,1470447508,1450,0
287269,0,False,False,1480477009,1480477009,1451,0
287270,0,False,False,1479756056,1479756056,1452,0
287271,0,False,False,1461704802,1461704802,1453,0
287272,0,False,False,1480528062,1480528062,1454,0
287273,0,False,False,1450578642,1450578642,1455,0
287274,0,False,False,1477283897,1477283897,1456,0
287325,0,False,False,1480635781,1480635781,1458,0
287326,0,False,False,1457730128,1457730128,1459,0
287327,0,False,False,1455131005,1455131005,1460,0
287328,0,False,False,1481334444,1481334444,1461,0
287333,0,False,False,1465092929,1465092929,1463,0
287334,0,False,False,1468073350,1468073350,1464,0
287352,0,False,False,1452274289,1452274289,1466,0
287353,0,False,False,1472912674,1472912674,1468,0
287354,0,False,False,1464375282,1464375282,1469,0
287355,0,False,False,1468266925,1468266925,1470,0
287356,0,False,False,1455587915,1455587915,1471,0
287392,0,False,False,1472906676,1472906676,1473,0
287393,0,False,False,1459190430,1459190430,1474,0
287394,0,False,False,1476614828,1476614828,1475,0
287395,0,False,False,1454700236,1454700236,1476,0
287396,0,False,False,1453793705,1453793705,1477,0
287397,0,False,False,1455126558,1455126558,1478,0
287398,0,False,False,1470174415,1470174415,1480,0
287399,0,False,False,1453233002,1453233002,1481,0
287400,0,False,False,1449165593,1449165593,1482,0
287401,0,False,False,1453325470,1453325470,1483,0
287402,0,False,False,1453884257,1453884257,1484,0
287406,0,False,False,1468604983,1468604983,1486,0
287407,0,False,False,1470709500,1470709500,1487,0
287408,0,False,False,1453687830,1453687830,1488,0
287409,0,False,False,1469274868,1469274868,1489,0
287446,0,False,False,1457713373,1457713373,1491,0
287447,0,False,False,1467125627,1467125627,1492,0
287448,0,False,False,1460335273,1460335273,1493,0
287449,0,False,False,1459505965,1459505965,1494,0
287450,0,False,False,1481730648,1481730648,1495,0
287451,0,False,False,1456873199,1456873199,1496,0
287457,0,False,False,1450657777,1450657777,1498,0
287458,0,False,False,1476101292,1476101292,1499,0
287462,0,False,False,1464879023,1464879023,1502,0
287463,0,False,False,1471447677,1471447677,1503,0
287464,0,False,False,1462789391,1462789391,1504,0
287465,0,False,False,1455037584,1455037584,1506,0
287549,0,False,False,1465162007,1465162007,1508,0
287550,0,False,False,1482193968,1482193968,1509,0
287551,0,False,False,1470206776,1470206776,1510,0
287552,0,False,False,1449587434,1449587434,1511,0
287553,0,False,False,1474559923,1474559923,1513,0
287554,0,False,False,1454340557,1454340557,1514,0
287560,0,False,False,1457736482,1457736482,1517,0
287562,0,False,False,1479403013,1479403013,1519,0
287563,0,False,False,1475002146,1475002146,1520,0
287601,0,False,False,1482428439,1482428439,1524,0
287617,0,False,False,1476238369,1476238369,1526,0
287619,0,False,False,1474068879,1474068879,1528,0
287620,0,False,False,1480389076,1480389076,1529,0
287621,0,False,False,1460956827,1460956827,1530,0
287622,0,False,False,1465316228,1465316228,1531,0
287623,0,False,False,1459278823,1459278823,1532,0
287624,0,False,False,1459322000,1459322000,1533,0
287625,0,False,False,1458997384,1458997384,1534,0
287626,0,False,False,1449581465,1449581465,1535,0
287627,0,False,False,1460386616,1460386616,1536,0
287629,0,False,False,1468489455,1468489455,1539,0
287816,0,False,False,1481120013,1481120013,1543,0
287817,0,False,False,1461873345,1461873345,1544,0
287818,0,False,False,1480367409,1480367409,1545,0
287819,0,False,False,1458331810,1458331810,1546,0
287820,0,False,False,1475193877,1475193877,1547,0
287824,0,False,False,1467227905,1467227905,1549,0
287825,0,False,False,1460881003,1460881003,1550,0
287826,0,False,False,1468978082,1468978082,1551,0
287827,0,False,False,1470219278,1470219278,1552,0
287828,0,False,False,1455523041,1455523041,1553,0
287829,0,False,False,1451665076,1451665076,1554,0
287830,0,False,False,1453813264,1453813264,1555,0
287831,0,False,False,1481896844,1481896844,1556,0
287832,0,False,False,1477422678,1477422678,1557,0
287833,0,False,False,1467330443,1467330443,1558,0
287834,0,False,False,1460231427,1460231427,1559,0
287835,0,False,False,1453856916,1453856916,1561,0
287836,0,False,False,1473671841,1473671841,1562,0
287837,0,False,False,1452889543,1452889543,1563,0
344466,0,False,False,1461786104,1461786104,1565,0
344467,0,False,False,1478352336,1478352336,1566,0
344468,0,False,False,1474087248,1474087248,1567,0
344469,0,False,False,1450386742,1450386742,1568,0
344470,0,False,False,1460930668,1460930668,1569,0
344471,0,False,False,1466176939,1466176939,1570,0
344472,0,False,False,1483040257,1483040257,1571,0
344484,0,False,False,1475497868,1475497868,1573,0
344485,0,False,False,1481317996,1481317996,1574,0
344486,0,False,False,1471736812,1471736812,1575,0
344487,0,False,False,1468506865,1468506865,1576,0
344488,0,False,False,1464669870,1464669870,1577,0
344489,0,False,False,1451778368,1451778368,1578,0
344493,0,False,False,1469549212,1469549212,1580,0
344494,0,False,False,1460375295,1460375295,1581,0
344566,0,False,False,1451048555,1451048555,1583,0
344567,0,False,False,1471153991,1471153991,1584,0
344575,0,False,False,1477164033,1477164033,1587,0
344576,0,False,False,1477164033,1477164033,1588,0
344577,0,False,False,1453135408,1453135408,1589,0
344578,0,False,False,1460641243,1460641243,1590,0
344579,0,False,False,1482761208,1482761208,1591,0
344580,0,False,False,1465784511,1465784511,1593,0
344581,0,False,False,1474375691,1474375691,1595,0
344586,0,False,False,1467569730,1467569730,1597,0
344587,0,False,False,1465567145,1465567145,1598,0
344588,0,False,False,1468933998,1468933998,1599,0
344589,0,False,False,1478915243,1478915243,1600,0
344590,0,False,False,1481984447,1481984447,1601,0
354401,0,False,False,1478723282,1478723282,1604,0
354402,0,False,False,1467392046,1467392046,1605,0
354988,0,False,False,1478870391,1478870391,1607,0
354989,0,False,False,1477691921,1477691921,1608,0
354990,0,False,False,1452262216,1452262216,1609,0
354991,0,False,False,1452005833,1452005833,1610,0
354992,0,False,False,1475207832,1475207832,1611,0
354993,0,False,False,1465933774,1465933774,1612,0
354995,0,False,False,1466875293,1466875293,1615,0
354996,0,False,False,1481683083,1481683083,1616,0
354997,0,False,False,1459798987,1459798987,1617,0
354998,0,False,False,1473278556,1473278556,1618,0
354999,0,False,False,1476557704,1476557704,1619,0
355000,0,False,False,1460120421,1460120421,1620,0
355001,0,False,False,1479600795,1479600795,1623,0
355002,0,False,False,1470938742,1470938742,1624,0
355003,0,False,False,1464123136,1464123136,1625,0
355004,0,False,False,1462212460,1462212460,1626,0
355008,0,False,False,1466175512,1466175512,1628,0
355009,0,False,False,1469860625,1469860625,1629,0
355010,0,False,False,1469860625,1469860625,1630,0
355011,0,False,False,1465494066,1465494066,1631,0
355012,0,False,False,1475659876,1475659876,1632,0
355013,0,False,False,1475659876,1475659876,1633,0
355014,0,False,False,1481360938,1481360938,1634,0
355015,0,False,False,1467950216,1467950216,1636,0
355019,0,False,False,1450009826,1450009826,1640,0
355020,0,False,False,1459676413,1459676413,1643,0
355021,0,False,False,1468257217,1468257217,1644,0
355022,0,False,False,1477377878,1477377878,1645,0
355023,0,False,False,1467200661,1467200661,1646,0
355024,0,False,False,1453937796,1453937796,1648,0
355025,0,False,False,1477152468,1477152468,1649,0
355026,0,False,False,1463934031,1463934031,1650,0
355027,0,False,False,1455481322,1455481322,1651,0
355038,0,False,False,1464123149,1464123149,1654,0
355039,0,False,False,1466978313,1466978313,1655,0
355040,0,False,False,1460652768,1460652768,1657,0
355041,0,False,False,1470270663,1470270663,1658,0
355042,0,False,False,1474639709,1474639709,1659,0
355043,0,False,False,1473717289,1473717289,1660,0
355044,0,False,False,1465510554,1465510554,1661,0
355045,0,False,False,1474214047,1474214047,1662,0
355046,0,False,False,1454605821,1454605821,1663,0
355047,0,False,False,1475860550,1475860550,1665,0
355048,0,False,False,1449723295,1449723295,1666,0
355049,0,False,False,1472334497,1472334497,1667,0
355066,0,False,False,1460059969,1460059969,1669,0
355067,0,False,False,1462120570,1462120570,1670,0
355068,0,False,False,1456793162,1456793162,1671,0
355069,0,False,False,1452027166,1452027166,1672,0
355070,0,False,False,1477913645,1477913645,1673,0
355071,0,False,False,1461849940,1461849940,1675,0
355072,0,False,False,1476726135,1476726135,1676,0
355073,0,False,False,1451913314,1451913314,1677,0
355074,0,False,False,1454018721,1454018721,1678,0
355075,0,False,False,1470573530,1470573530,1679,0
355076,0,False,False,1459215603,1459215603,1680,0
355077,0,False,False,1472880395,1472880395,1681,0
355078,0,False,False,1472222991,1472222991,1683,0
355079,0,False,False,1479594431,1479594431,1684,0
355092,0,False,False,1460418694,1460418694,1686,0
355093,0,False,False,1451813390,1451813390,1689,0
355094,0,False,False,1474753877,1474753877,1690,0
355096,0,False,False,1461773373,1461773373,1692,0
355097,0,False,False,1481582562,1481582562,1693,0
355098,0,False,False,1461160495,1461160495,1696,0
355104,0,False,False,1462833672,1462833672,1698,0
355106,0,False,False,1452632806,1452632806,1700,0
355110,0,False,False,1451488290,1451488290,1702,0
355111,0,False,False,1460664710,1460664710,1703,0
355112,0,False,False,1476592645,1476592645,1704,0
355113,0,False,False,1476592645,1476592645,1705,0
355137,0,False,False,1464488460,1464488460,1708,0
355142,0,False,False,1480619584,1480619584,1712,0
355143,0,False,False,1456265575,1456265575,1713,0
355144,0,False,False,1453752639,1453752639,1714,0
355145,0,False,False,1466455674,1466455674,1715,0
355146,0,False,False,1480693085,1480693085,1716,0
355150,0,False,False,1455057446,1455057446,1719,0
355151,0,False,False,1466357795,1466357795,1720,0
355152,0,False,False,1477943387,1477943387,1722,0
355153,0,False,False,1451062138,1451062138,1723,0
355154,0,False,False,1481548885,1481548885,1724,0
355155,0,False,False,1466936120,1466936120,1725,0
355156,0,False,False,1471360740,1471360740,1726,0
355157,0,False,False,1463970631,1463970631,1728,0
355158,0,False,False,1457883797,1457883797,1729,0
355159,0,False,False,1475000360,1475000360,1730,0
355160,0,False,False,1454183548,1454183548,1731,0
355161,0,False,False,1464489252,1464489252,1732,0
355162,0,False,False,1460295124,1460295124,1733,0
355172,0,False,False,1462986949,1462986949,1735,0
355173,0,False,False,1469095433,1469095433,1737,0
355174,0,False,False,1450460840,1450460840,1738,0
355175,0,False,False,1466009092,1466009092,1739,0
355176,0,False,False,1472561670,1472561670,1740,0
355177,0,False,False,1480878107,1480878107,1742,0
355178,0,False,False,1463414428,1463414428,1743,0
355179,0,False,False,1474775054,1474775054,1744,0
355191,0,False,False,1477069950,1477069950,1746,0
355192,0,False,False,1466124316,1466124316,1747,0
355193,0,False,False,1473833440,1473833440,1748,0
355194,0,False,False,1450163927,1450163927,1749,0
355195,0,False,False,1481245078,1481245078,1750,0
355196,0,False,False,1462973837,1462973837,1751,0
355197,0,False,False,1483307702,1483307702,1752,0
355198,0,False,False,1449255368,1449255368,1753,0
355199,0,False,False,1461860583,1461860583,1755,0
355200,0,False,False,1453065677,1453065677,1756,0
355201,0,False,False,1461671717,1461671717,1757,0
355203,0,False,False,1482979923,1482979923,1760,0
355204,0,False,False,1454610460,1454610460,1761,0
355205,0,False,False,1466592401,1466592401,1762,0
355206,0,False,False,1452299685,1452299685,1763,0
355212,0,False,False,1471934470,1471934470,1765,0
355213,0,False,False,1469127199,1469127199,1766,0
355214,0,False,False,1468395137,1468395137,1767,0
355215,0,False,False,1459004857,1459004857,1768,0
355216,0,False,False,1452067943,1452067943,1769,0
355217,0,False,False,1457233125,1457233125,1770,0
355218,0,False,False,1469612724,1469612724,1772,0
355219,0,False,False,1465316271,1465316271,1773,0
355220,0,False,False,1464452458,1464452458,1774,0
355221,0,False,False,1453403805,1453403805,1775,0
355222,0,False,False,1461589052,1461589052,1778,0
355223,0,False,False,1461860448,1461860448,1780,0
355224,0,False,False,1458782683,1458782683,1781,0
355263,0,False,False,1475616337,1475616337,1784,0
355264,0,False,False,1479931528,1479931528,1785,0
355272,0,False,False,1468488038,1468488038,1789,0
355273,0,False,False,1454632969,1454632969,1790,0
355274,0,False,False,1476695510,1476695510,1791,0
355275,0,False,False,1478967966,1478967966,1792,0
355276,0,False,False,1479727253,1479727253,1793,0
355277,0,False,False,1472769865,1472769865,1794,0
355278,0,False,False,1451869892,1451869892,1795,0
355279,0,False,False,1453909580,1453909580,1796,0
355697,0,False,False,1470625416,1470625416,1799,0
355698,0,False,False,1467142092,1467142092,1800,0
355699,0,False,False,1462970942,1462970942,1801,0
356637,0,False,False,1482296612,1482296612,1803,0
356642,0,False,False,1483455578,1483455578,1805,0
356643,0,False,False,1467834692,1467834692,1806,0
356644,0,False,False,1465011496,1465011496,1807,0
356645,0,False,False,1474042779,1474042779,1808,0
356646,0,False,False,1458567121,1458567121,1809,0
356647,0,False,False,1452633538,1452633538,1810,0
356648,0,False,False,1452973357,1452973357,1811,0
356649,0,False,False,1454174734,1454174734,1812,0
356653,0,False,False,1452955880,1452955880,1815,0
356654,0,False,False,1451178981,1451178981,1816,0
356655,0,False,False,1473710030,1473710030,1817,0
356656,0,False,False,1477618760,1477618760,1818,0
356657,0,False,False,1461979454,1461979454,1819,0
356658,0,False,False,1460939931,1460939931,1820,0
356659,0,False,False,1472259586,1472259586,1821,0
356660,0,False,False,1451277974,1451277974,1822,0
356661,0,False,False,1463527421,1463527421,1823,0
356662,0,False,False,1466474198,1466474198,1825,0
356663,0,False,False,1455658183,1455658183,1826,0
356664,0,False,False,1483060727,1483060727,1827,0
356666,0,False,False,1454297902,1454297902,1830,0
356667,0,False,False,1482044685,1482044685,1831,0
398577,0,False,False,1452517342,1452517342,1836,0
398578,0,False,False,1451395295,1451395295,1837,0
398579,0,False,False,1460162102,1460162102,1838,0
398609,0,False,False,1472919231,1472919231,1841,0
398610,0,False,False,1455500824,1455500824,1842,0
398611,0,False,False,1454345221,1454345221,1843,0
398612,0,False,False,1466190291,1466190291,1845,0
398613,0,False,False,1473783615,1473783615,1846,0
398614,0,False,False,1452505648,1452505648,1847,0
398615,0,False,False,1462313291,1462313291,1848,0
398616,0,False,False,1478898446,1478898446,1849,0
398617,0,False,False,1466982871,1466982871,1850,0
398618,0,False,False,1479404167,1479404167,1851,0
398619,0,False,False,1477878076,1477878076,1852,0
398620,0,False,False,1458595479,1458595479,1853,0
398621,0,False,False,1479392865,1479392865,1854,0
398622,0,False,False,1451359469,1451359469,1855,0
398623,0,False,False,1452864093,1452864093,1856,0
398812,0,False,False,1480728358,1480728358,1859,0
398813,0,False,False,1461849817,1461849817,1860,0
398816,0,False,False,1470280954,1470280954,1862,0
398817,0,False,False,1472741504,1472741504,1863,0
398818,0,False,False,1471276576,1471276576,1864,0
398819,0,False,False,1461780422,1461780422,1865,0
398820,0,False,False,1481920627,1481920627,1866,0
398821,0,False,False,1477155797,1477155797,1867,0
398822,0,False,False,1450434275,1450434275,1868,0
398823,0,False,False,1456435296,1456435296,1870,0
398829,0,False,False,1465756898,1465756898,1873,0
398830,0,False,False,1481208039,1481208039,1874,0
398980,0,False,False,1475849470,1475849470,1877,0
398981,0,False,False,1460755978,1460755978,1878,0
398982,0,False,False,1477090937,1477090937,1879,0
398983,0,False,False,1462437155,1462437155,1880,0
398984,0,False,False,1452828945,1452828945,1881,0
399815,0,False,False,1451765140,1451765140,1883,0
399816,0,False,False,1451765140,1451765140,1884,0
399817,0,False,False,1482573433,1482573433,1885,0
399823,0,False,False,1482618306,1482618306,1888,0
399824,0,False,False,1462212515,1462212515,1889,0
399825,0,False,False,1453302580,1453302580,1890,0
399826,0,False,False,1452230757,1452230757,1891,0
454673,0,False,False,1472611925,1472611925,1895,0
454674,0,False,False,1480366118,1480366118,1896,0
454675,0,False,False,1465968614,1465968614,1897,0
454676,0,False,False,1466742030,1466742030,1898,0
454677,0,False,False,1457196502,1457196502,1899,0
454678,0,False,False,1459219637,1459219637,1900,0
454679,0,False,False,1470593187,1470593187,1902,0
454680,0,False,False,1453323420,1453323420,1903,0
454681,0,False,False,1475396832,1475396832,1904,0
454682,0,False,False,1453785709,1453785709,1905,0
454683,0,False,False,1472059814,1472059814,1906,0
454685,0,False,False,1465213820,1465213820,1908,0
454686,0,False,False,1480161982,1480161982,1909,0
454687,0,False,False,1471928706,1471928706,1910,0
454688,0,False,False,1458236973,1458236973,1911,0
454689,0,False,False,1463466413,1463466413,1912,0
454729,0,False,False,1466704422,1466704422,1914,0
454730,0,False,False,1478648697,1478648697,1915,0
454731,0,False,False,1464462650,1464462650,1916,0
454732,0,False,False,1468704873,1468704873,1917,0
454733,0,False,False,1477354891,1477354891,1918,0
454736,0,False,False,1464798081,1464798081,1920,0
454737,0,False,False,1451682335,1451682335,1921,0
454738,0,False,False,1459230517,1459230517,1923,0
454739,0,False,False,1471814326,1471814326,1924,0
454740,0,False,False,1458527307,1458527307,1925,0
454741,0,False,False,1474346742,1474346742,1926,0
454746,0,False,False,1476320956,1476320956,1929,0
454747,0,False,False,1468425872,1468425872,1930,0
454748,0,False,False,1472906398,1472906398,1931,0
454749,0,False,False,1458622168,1458622168,1932,0
454750,0,False,False,1478896231,1478896231,1933,0
454751,0,False,False,1454351268,1454351268,1934,0
454753,0,False,False,1459326909,1459326909,1936,0
454754,0,False,False,1470201204,1470201204,1937,0
454755,0,False,False,1481918432,1481918432,1938,0
454756,0,False,False,1473962188,1473962188,1941,0
454757,0,False,False,1451845852,1451845852,1942,0
454758,0,False,False,1450377175,1450377175,1943,0
454759,0,False,False,1458816332,1458816332,1944,0
454760,0,False,False,1471199816,1471199816,1945,0
454762,0,False,False,1461134865,1461134865,1947,0
454763,0,False,False,1461134865,1461134865,1948,0
454764,0,False,False,1470447072,1470447072,1949,0
454765,0,False,False,1470447187,1470447187,1950,0
454766,0,False,False,1482470878,1482470878,1951,0
454767,0,False,False,1478289164,1478289164,1952,0
454768,0,False,False,1452141416,1452141416,1953,0
454769,0,False,False,1474831865,1474831865,1954,0
454772,0,False,False,1470048264,1470048264,1956,0
454773,0,False,False,1463753338,1463753338,1957,0
454774,0,False,False,1456761385,1456761385,1958,0
454775,0,False,False,1482518448,1482518448,1959,0
454776,0,False,False,1454745477,1454745477,1960,0
454866,0,False,False,1459180208,1459180208,1964,0
454883,0,False,False,1474573004,1474573004,1966,0
454896,0,False,False,1449546230,1449546230,1968,0
454897,0,False,False,1456446490,1456446490,1969,0
454898,0,False,False,1458673462,1458673462,1971,0
454899,0,False,False,1462657813,1462657813,1972,0
455221,0,False,False,1472675189,1472675189,1974,0
455222,0,False,False,1465946558,1465946558,1975,0
455223,0,False,False,1480631823,1480631823,1976,0
455224,0,False,False,1474594872,1474594872,1978,0
455225,0,False,False,1479147299,1479147299,1979,0
455227,0,False,False,1466947596,1466947596,1981,0
455228,0,False,False,1474306237,1474306237,1982,0
455232,0,False,False,1455699481,1455699481,1984,0
455233,0,False,False,1455699481,1455699481,1985,0
455234,0,False,False,1458497587,1458497587,1986,0
455235,0,False,False,1463954124,1463954124,1987,0
455238,0,False,False,1459457664,1459457664,1989,0
455239,0,False,False,1472075790,1472075790,1990,0
455240,0,False,False,1481465163,1481465163,1991,0
455241,0,False,False,1469040599,1469040599,1992,0
455242,0,False,False,1458543843,1458543843,1993,0
455243,0,False,False,1458543843,1458543843,1994,0
455244,0,False,False,1481118478,1481118478,1995,0
455245,0,False,False,1468792095,1468792095,1996,0
455246,0,False,False,1478293066,1478293066,1997,0
455247,0,False,False,1471276289,1471276289,1998,0
455248,0,False,False,1471637039,1471637039,1999,0
455249,0,False,False,1457703534,1457703534,2002,0
455256,0,False,False,1458084162,1458084162,2005,0
455276,0,False,False,1460087364,1460087364,2008,0
455277,0,False,False,1467842249,1467842249,2010,0
455278,0,False,False,1472141828,1472141828,2011,0
455279,0,False,False,1449105497,1449105497,2012,0
455280,0,False,False,1462884560,1462884560,2013,0
455281,0,False,False,1466302636,1466302636,2014,0
455282,0,False,False,1483125352,1483125352,2015,0
455303,0,False,False,1452005877,1452005877,2017,0
455304,0,False,False,1460751503,1460751503,2018,0
455305,0,False,False,1460751503,1460751503,2019,0
455306,0,False,False,1482983054,1482983054,2020,0
455307,0,False,False,1478983871,1478983871,2021,0
455308,0,False,False,1479097814,1479097814,2022,0
455311,0,False,False,1474050696,1474050696,2024,0
455312,0,False,False,1464647130,1464647130,2025,0
455313,0,False,False,1478899463,1478899463,2026,0
455314,0,False,False,1470360552,1470360552,2027,0
455315,0,False,False,1461872011,1461872011,2029,0
455316,0,False,False,1474073417,1474073417,2030,0
455317,0,False,False,1460416744,1460416744,2031,0
455318,0,False,False,1480821112,1480821112,2032,0
455407,0,False,False,1456179671,1456179671,2035,0
455408,0,False,False,1450369988,1450369988,2036,0
455410,0,False,False,1465012324,1465012324,2038,0
455411,0,False,False,1451249717,1451249717,2039,0
455412,0,False,False,1461206664,1461206664,2040,0
455660,0,False,False,1457026592,1457026592,2042,0
455661,0,False,False,1473867284,1473867284,2043,0
455662,0,False,False,1467566886,1467566886,2044,0
455663,0,False,False,1465602459,1465602459,2045,0
455664,0,False,False,1457831269,1457831269,2046,0
455683,0,False,False,1451313629,1451313629,2048,0
455689,0,False,False,1465832904,1465832904,2050,0
455690,0,False,False,1480702194,1480702194,2051,0
455691,0,False,False,1465885785,1465885785,2054,0
455692,0,False,False,1480462255,1480462255,2055,0
455693,0,False,False,1480289141,1480289141,2056,0
455694,0,False,False,1462232756,1462232756,2057,0
455695,0,False,False,1478001732,1478001732,2058,0
455696,0,False,False,1471273134,1471273134,2059,0
455697,0,False,False,1450445667,1450445667,2061,0
455698,0,False,False,1457746043,1457746043,2064,0
455699,0,False,False,1461002760,1461002760,2065,0
455700,0,False,False,1470691835,1470691835,2066,0
455701,0,False,False,1470691835,1470691835,2067,0
455702,0,False,False,1467170414,1467170414,2068,0
455703,0,False,False,1478560307,1478560307,2069,0
455704,0,False,False,1469319776,1469319776,2070,0
455705,0,False,False,1476841711,1476841711,2072,0
455706,0,False,False,1473373984,1473373984,2073,0
455708,0,False,False,1452748212,1452748212,2075,0
455709,0,False,False,1455132130,1455132130,2076,0
455710,0,False,False,1457712428,1457712428,2077,0
455711,0,False,False,1464139833,1464139833,2078,0
455712,0,False,False,1467198621,1467198621,2080,0
455713,0,False,False,1464881671,1464881671,2081,0
455714,0,False,False,1473862108,1473862108,2083,0
455715,0,False,False,1455393636,1455393636,2085,0
455716,0,False,False,1462871981,1462871981,2086,0
455730,0,False,False,1469044422,1469044422,2089,0
455731,0,False,False,1468862118,1468862118,2090,0
455735,0,False,False,1458523560,1458523560,2092,0
455739,0,False,False,1463411070,1463411070,2094,0
455740,0,False,False,1462573748,1462573748,2096,0
455741,0,False,False,1466212370,1466212370,2097,0
455746,0,False,False,1460562628,1460562628,2099,0
455762,0,False,False,1482535043,1482535043,2101,0
455763,0,False,False,1454338869,1454338869,2102,0
455764,0,False,False,1454193321,1454193321,2103,0
455765,0,False,False,1464791756,1464791756,2104,0
455766,0,False,False,1459774928,1459774928,2105,0
455767,0,False,False,1478054623,1478054623,2106,0
455941,0,False,False,1460658857,1460658857,2110,0
455942,0,False,False,1483137103,1483137103,2111,0
455947,0,False,False,1470888827,1470888827,2113,0
455948,0,False,False,1471189797,1471189797,2114,0
455949,0,False,False,1452153576,1452153576,2115,0
455950,0,False,False,1464316816,1464316816,2116,0
455951,0,False,False,1471375199,1471375199,2117,0
455952,0,False,False,1455551712,1455551712,2118,0
455953,0,False,False,1454207755,1454207755,2119,0
455954,0,False,False,1459180206,1459180206,2120,0
455955,0,False,False,1469755748,1469755748,2121,0
455956,0,False,False,1475506014,1475506014,2122,0
455957,0,False,False,1479599656,1479599656,2123,0
455958,0,False,False,1474227419,1474227419,2124,0
455959,0,False,False,1467995977,1467995977,2125,0
455960,0,False,False,1481458117,1481458117,2126,0
455961,0,False,False,1477624025,1477624025,2127,0
455962,0,False,False,1473529955,1473529955,2128,0
455963,0,False,False,1472769358,1472769358,2130,0
455964,0,False,False,1464682345,1464682345,2131,0
455966,0,False,False,1451398221,1451398221,2133,0
455967,0,False,False,1474931963,1474931963,2135,0
455968,0,False,False,1454178180,1454178180,2136,0
455969,0,False,False,1481555377,1481555377,2137,0
455970,0,False,False,1456167199,1456167199,2138,0
455972,0,False,False,1453384855,1453384855,2141,0
455973,0,False,False,1462709139,1462709139,2142,0
455974,0,False,False,1464486403,1464486403,2143,0
455975,0,False,False,1453494440,1453494440,2144,0
455976,0,False,False,1452719077,1452719077,2145,0
455977,0,False,False,1463166024,1463166024,2148,0
455978,0,False,False,1461564368,1461564368,2149,0
455979,0,False,False,1469053366,1469053366,2150,0
455980,0,False,False,1476159789,1476159789,2151,0
456003,0,False,False,1469140212,1469140212,2154,0
456004,0,False,False,1474471370,1474471370,2155,0
456005,0,False,False,1451240229,1451240229,2156,0
456006,0,False,False,1471006804,1471006804,2157,0
456007,0,False,False,1478047945,1478047945,2158,0
456008,0,False,False,1476657394,1476657394,2159,0
456009,0,False,False,1463084292,1463084292,2160,0
456010,0,False,False,1472134564,1472134564,2161,0
456011,0,False,False,1449963094,1449963094,2162,0
456012,0,False,False,1470222341,1470222341,2163,0
459982,0,False,False,1451669178,1451669178,2166,0
459983,0,False,False,1461308686,1461308686,2167,0
459984,0,False,False,1469287401,1469287401,2168,0
459985,0,False,False,1472008227,1472008227,2170,0
459986,0,False,False,1456691682,1456691682,2171,0
459987,0,False,False,1469619438,1469619438,2172,0
459988,0,False,False,1468614248,1468614248,2173,0
459989,0,False,False,1466683990,1466683990,2175,0
459996,0,False,False,1470394691,1470394691,2177,0
459997,0,False,False,1456359235,1456359235,2178,0
459999,0,False,False,1452859709,1452859709,2180,0
460000,0,False,False,1474595504,1474595504,2181,0
461408,0,False,False,1471926052,1471926052,2185,0
461412,0,False,False,1450991966,1450991966,2187,0
461413,0,False,False,1471730606,1471730606,2188,0
461414,0,False,False,1471730606,1471730606,2189,0
461424,0,False,False,1461511459,1461511459,2193,0
461429,0,False,False,1460320876,1460320876,2202,0
461430,0,False,False,1460320876,1460320876,2203,0
461437,0,False,False,1453919235,1453919235,2206,0
461438,0,False,False,1474529536,1474529536,2207,0
461439,0,False,False,1463494068,1463494068,2208,0
461440,0,False,False,1471277394,1471277394,2209,0
461441,0,False,False,1476488509,1476488509,2210,0
461442,0,False,False,1463025819,1463025819,2211,0
461443,0,False,False,1471280673,1471280673,2212,0
461444,0,False,False,1482889771,1482889771,2213,0
461445,0,False,False,1449932839,1449932839,2214,0
461446,0,False,False,1472867133,1472867133,2215,0
461447,0,False,False,1464836006,1464836006,2216,0
461448,0,False,False,1463001167,1463001167,2217,0
461449,0,False,False,1477276113,1477276113,2218,0
461450,0,False,False,1476356078,1476356078,2220,0
461451,0,False,False,1471317846,1471317846,2221,0
461452,0,False,False,1482033346,1482033346,2222,0
461453,0,False,False,1456955414,1456955414,2223,0
461454,0,False,False,1482127392,1482127392,2224,0
461455,0,False,False,1470580020,1470580020,2225,0
461456,0,False,False,1460665704,1460665704,2226,0
461457,0,False,False,1468631191,1468631191,2227,0
461458,0,False,False,1474563354,1474563354,2229,0
461459,0,False,False,1465317744,1465317744,2230,0
461460,0,False,False,1455470809,1455470809,2231,0
461461,0,False,False,1451413748,1451413748,2232,0
461462,0,False,False,1465414762,1465414762,2233,0
461463,0,False,False,1461858667,1461858667,2234,0
461464,0,False,False,1478960441,1478960441,2235,0
461497,0,False,False,1451948653,1451948653,2237,0
461498,0,False,False,1453887372,1453887372,2238,0
461499,0,False,False,1467988481,1467988481,2239,0
461500,0,False,False,1474672122,1474672122,2240,0
461501,0,False,False,1458559018,1458559018,2241,0
461502,0,False,False,1472502192,1472502192,2242,0
461503,0,False,False,1461765854,1461765854,2243,0
461504,0,False,False,1468263775,1468263775,2244,0
461505,0,False,False,1481891254,1481891254,2245,0
461506,0,False,False,1456755197,1456755197,2247,0
461508,0,False,False,1453322517,1453322517,2251,0
461509,0,False,False,1450241125,1450241125,2252,0
461510,0,False,False,1466264608,1466264608,2253,0
461511,0,False,False,1449025549,1449025549,2255,0
461512,0,False,False,1455119699,1455119699,2257,0
461513,0,False,False,1456866163,1456866163,2258,0
461514,0,False,False,1468880825,1468880825,2259,0
461515,0,False,False,1473378778,1473378778,2260,0
461516,0,False,False,1467483210,1467483210,2261,0
461517,0,False,False,1478693270,1478693270,2262,0
461518,0,False,False,1463934170,1463934170,2264,0
461519,0,False,False,1450808647,1450808647,2265,0
461520,0,False,False,1459318382,1459318382,2266,0
461521,0,False,False,1459318382,1459318382,2267,0
461522,0,False,False,1452011077,1452011077,2268,0
461523,0,False,False,1465766336,1465766336,2269,0
461524,0,False,False,1452870069,1452870069,2270,0
461525,0,False,False,1462366933,1462366933,2271,0
461526,0,False,False,1482627543,1482627543,2272,0
461527,0,False,False,1468885535,1468885535,2273,0
461532,0,False,False,1452252542,1452252542,2276,0
461533,0,False,False,1472790292,1472790292,2277,0
461534,0,False,False,1471327058,1471327058,2278,0
461535,0,False,False,1472295142,1472295142,2280,0
461536,0,False,False,1449495350,1449495350,2281,0
461537,0,False,False,1450325519,1450325519,2282,0
461538,0,False,False,1463137670,1463137670,2283,0
461539,0,False,False,1477337668,1477337668,2284,0
461540,0,False,False,1461398673,1461398673,2285,0
461541,0,False,False,1465187677,1465187677,2286,0
461585,0,False,False,1473970033,1473970033,2288,0
461586,0,False,False,1472339742,1472339742,2289,0
461588,0,False,False,1469225510,1469225510,2291,0
461589,0,False,False,1469225510,1469225510,2292,0
461590,0,False,False,1470904773,1470904773,2293,0
461591,0,False,False,1464198274,1464198274,2294,0
461594,0,False,False,1465751111,1465751111,2298,0
463504,0,False,False,1479060653,1479060653,2300,0
463505,0,False,False,1477111842,1477111842,2301,0
463506,0,False,False,1451174993,1451174993,2302,0
463510,0,False,False,1472847532,1472847532,2305,0
463511,0,False,False,1452541801,1452541801,2306,0
463512,0,False,False,1472434825,1472434825,2308,0
463513,0,False,False,1458538154,1458538154,2309,0
463514,0,False,False,1480571864,1480571864,2310,0
463515,0,False,False,1453306623,1453306623,2311,0
463516,0,False,False,1474691236,1474691236,2312,0
463522,0,False,False,1452520738,1452520738,2314,0
463523,0,False,False,1450203396,1450203396,2315,0
463524,0,False,False,1480358810,1480358810,2317,0
463525,0,False,False,1477892303,1477892303,2318,0
463526,0,False,False,1482828649,1482828649,2319,0
463527,0,False,False,1455015304,1455015304,2320,0
463528,0,False,False,1471817287,1471817287,2321,0
463529,0,False,False,1473961562,1473961562,2322,0
463530,0,False,False,1470850798,1470850798,2323,0
463531,0,False,False,1456358952,1456358952,2324,0
463532,0,False,False,1455156278,1455156278,2325,0
463534,0,False,False,1463522832,1463522832,2328,0
463535,0,False,False,1480607609,1480607609,2330,0
463536,0,False,False,1473831585,1473831585,2331,0
463537,0,False,False,1459012727,1459012727,2333,0
463538,0,False,False,1462678877,1462678877,2334,0
463539,0,False,False,1452109402,1452109402,2335,0
463541,0,False,False,1474759995,1474759995,2337,0
463542,0,False,False,1474421807,1474421807,2338,0
463543,0,False,False,1455247053,1455247053,2339,0
463544,0,False,False,1463745830,1463745830,2342,0
463545,0,False,False,1466639320,1466639320,2343,0
463546,0,False,False,1461933010,1461933010,2344,0
463547,0,False,False,1478905031,1478905031,2346,0
463548,0,False,False,1477974927,1477974927,2347,0
463549,0,False,False,1476632557,1476632557,2348,0
463550,0,False,False,1461571687,1461571687,2349,0
463551,0,False,False,1478547804,1478547804,2350,0
463552,0,False,False,1456776117,1456776117,2351,0
463554,0,False,False,1452449508,1452449508,2353,0
463586,0,False,False,1452938839,1452938839,2355,0
463587,0,False,False,1481319605,1481319605,2356,0
463588,0,False,False,1477272020,1477272020,2357,0
463589,0,False,False,1465935318,1465935318,2358,0
463593,0,False,False,1469277297,1469277297,2360,0
463595,0,False,False,1455428546,1455428546,2362,0
463596,0,False,False,1455428546,1455428546,2363,0
463597,0,False,False,1469489588,1469489588,2364,0
463598,0,False,False,1459529442,1459529442,2365,0
463599,0,False,False,1479159740,1479159740,2367,0
463600,0,False,False,1481898992,1481898992,2368,0
463601,0,False,False,1454443917,1454443917,2369,0
463602,0,False,False,1451920134,1451920134,2370,0
463603,0,False,False,1451958309,1451958309,2371,0
465245,0,False,False,1451166062,1451166062,2375,0
465246,0,False,False,1458769346,1458769346,2377,0
465247,0,False,False,1459181499,1459181499,2378,0
465281,0,False,False,1470989001,1470989001,2383,0
465282,0,False,False,1461312291,1461312291,2385,0
465283,0,False,False,1474430600,1474430600,2386,0
465938,0,False,False,1466857786,1466857786,2389,0
465939,0,False,False,1482754311,1482754311,2390,0
465940,0,False,False,1470854329,1470854329,2391,0
465941,0,False,False,1461583735,1461583735,2392,0
465944,0,False,False,1455669000,1455669000,2394,0
466748,0,False,False,1471077832,1471077832,2398,0
466749,0,False,False,1471077832,1471077832,2399,0
467153,0,False,False,1465103766,1465103766,2401,0
467154,0,False,False,1459455730,1459455730,2403,0
467155,0,False,False,1477021514,1477021514,2404,0
467170,0,False,False,1463577172,1463577172,2409,0
467171,0,False,False,1474611486,1474611486,2410,0
467172,0,False,False,1471871048,1471871048,2411,0
467173,0,False,False,1466039837,1466039837,2412,0
467174,0,False,False,1460472148,1460472148,2413,0
467175,0,False,False,1481105957,1481105957,2414,0
467176,0,False,False,1454377850,1454377850,2416,0
467177,0,False,False,1462690972,1462690972,2417,0
467178,0,False,False,1473783594,1473783594,2419,0
467179,0,False,False,1458763663,1458763663,2420,0
467180,0,False,False,1480012160,1480012160,2421,0
467181,0,False,False,1472065646,1472065646,2422,0
467182,0,False,False,1463067362,1463067362,2423,0
467183,0,False,False,1468731491,1468731491,2424,0
467184,0,False,False,1458494671,1458494671,2426,0
467185,0,False,False,1459383728,1459383728,2427,0
467214,0,False,False,1459701225,1459701225,2430,0
467215,0,False,False,1463520618,1463520618,2431,0
467216,0,False,False,1474649912,1474649912,2432,0
467217,0,False,False,1471575578,1471575578,2433,0
467218,0,False,False,1470266343,1470266343,2434,0
467232,0,False,False,1478018630,1478018630,2436,0
467234,0,False,False,1467720233,1467720233,2438,0
467235,0,False,False,1462116258,1462116258,2439,0
467236,0,False,False,1470240706,1470240706,2440,0
467237,0,False,False,1471192983,1471192983,2441,0
467238,0,False,False,1452069554,1452069554,2442,0
467239,0,False,False,1474561583,1474561583,2444,0
467240,0,False,False,1452156153,1452156153,2446,0
467241,0,False,False,1481042637,1481042637,2447,0
467242,0,False,False,1471823677,1471823677,2448,0
467329,0,False,False,1471269850,1471269850,2450,0
467330,0,False,False,1469678645,1469678645,2451,0
467331,0,False,False,1449323202,1449323202,2452,0
467332,0,False,False,1451727591,1451727591,2453,0
467333,0,False,False,1472224812,1472224812,2454,0
467334,0,False,False,1452711444,1452711444,2455,0
467335,0,False,False,1450448395,1450448395,2457,0
467336,0,False,False,1463436062,1463436062,2458,0
467337,0,False,False,1470727484,1470727484,2459,0
467338,0,False,False,1466654522,1466654522,2460,0
467339,0,False,False,1463229193,1463229193,2461,0
467340,0,False,False,1454975823,1454975823,2463,0
467341,0,False,False,1454659720,1454659720,2465,0
467515,0,False,False,1454068828,1454068828,2468,0
467516,0,False,False,1449442321,1449442321,2469,0
467517,0,False,False,1467823493,1467823493,2470,0
467518,0,False,False,1464173831,1464173831,2472,0
467519,0,False,False,1463028262,1463028262,2473,0
467520,0,False,False,1461356183,1461356183,2474,0
467521,0,False,False,1463413493,1463413493,2476,0
467522,0,False,False,1470675122,1470675122,2477,0
467523,0,False,False,1482772138,1482772138,2478,0
467524,0,False,False,1467635352,1467635352,2481,0
467525,0,False,False,1454726460,1454726460,2482,0
467526,0,False,False,1467775153,1467775153,2483,0
467528,0,False,False,1468609193,1468609193,2485,0
467529,0,False,False,1452865502,1452865502,2486,0
467530,0,False,False,1452969380,1452969380,2487,0
467531,0,False,False,1479227755,1479227755,2488,0
467532,0,False,False,1476332219,1476332219,2489,0
467537,0,False,False,1456728371,1456728371,2492,0
467538,0,False,False,1456728371,1456728371,2493,0
467539,0,False,False,1481502915,1481502915,2494,0
467540,0,False,False,1457318334,1457318334,2495,0
467541,0,False,False,1449955903,1449955903,2496,0
467544,0,False,False,1474513393,1474513393,2498,0
467545,0,False,False,1465130370,1465130370,2499,0
467546,0,False,False,1458572044,1458572044,2500,0
467547,0,False,False,1457465805,1457465805,2501,0
467548,0,False,False,1473514209,1473514209,2502,0
467549,0,False,False,1478519091,1478519091,2503,0
467550,0,False,False,1456102907,1456102907,2504,0
467551,0,False,False,1466696045,1466696045,2505,0
467552,0,False,False,1457670784,1457670784,2506,0
467590,0,False,False,1452896007,1452896007,2508,0
467591,0,False,False,1453915867,1453915867,2509,0
467592,0,False,False,1477311890,1477311890,2510,0
467593,0,False,False,1456116867,1456116867,2511,0
467594,0,False,False,1453120706,1453120706,2512,0
467595,0,False,False,1459803372,1459803372,2513,0
467596,0,False,False,1455308738,1455308738,2514,0
467597,0,False,False,1474289106,1474289106,2515,0
467598,0,False,False,1468672850,1468672850,2516,0
467599,0,False,False,1474342026,1474342026,2517,0
467653,0,False,False,1469800192,1469800192,2521,0
467654,0,False,False,1458416031,1458416031,2522,0
467655,0,False,False,1468440357,1468440357,2523,0
467657,0,False,False,1453040554,1453040554,2525,0
467658,0,False,False,1471110040,1471110040,2526,0
467659,0,False,False,1457217712,1457217712,2527,0
467660,0,False,False,1465530870,1465530870,2528,0
467661,0,False,False,1466730278,1466730278,2529,0
467662,0,False,False,1450979849,1450979849,2530,0
467663,0,False,False,1469647292,1469647292,2531,0
467664,0,False,False,1455888258,1455888258,2532,0
467665,0,False,False,1459427226,1459427226,2533,0
467666,0,False,False,1482066042,1482066042,2534,0
467667,0,False,False,1473173708,1473173708,2535,0
467668,0,False,False,1466073858,1466073858,2537,0
467669,0,False,False,1482828249,1482828249,2538,0
467670,0,False,False,1472073838,1472073838,2540,0
467706,0,False,False,1461765269,1461765269,2543,0
468042,0,False,False,1466105162,1466105162,2548,0
468043,0,False,False,1458968116,1458968116,2550,0
468044,0,False,False,1451374640,1451374640,2551,0
468045,0,False,False,1455905154,1455905154,2552,0
468046,0,False,False,1477188843,1477188843,2553,0
468047,0,False,False,1474259521,1474259521,2554,0
468048,0,False,False,1466474988,1466474988,2555,0
468049,0,False,False,1458834023,1458834023,2556,0
468050,0,False,False,1460057524,1460057524,2557,0
468051,0,False,False,1458940839,1458940839,2558,0
468052,0,False,False,1463902954,1463902954,2559,0
468053,0,False,False,1469812198,1469812198,2561,0
468054,0,False,False,1464372213,1464372213,2562,0
468055,0,False,False,1467785193,1467785193,2563,0
468056,0,False,False,1479169501,1479169501,2564,0
468070,0,False,False,1478926582,1478926582,2568,0
468071,0,False,False,1462124545,1462124545,2569,0
468072,0,False,False,1482125981,1482125981,2570,0
468073,0,False,False,1453046180,1453046180,2571,0
468074,0,False,False,1475194831,1475194831,2572,0
468075,0,False,False,1472645103,1472645103,2573,0
468076,0,False,False,1464703324,1464703324,2576,0
468077,0,False,False,1450320971,1450320971,2577,0
468078,0,False,False,1449309368,1449309368,2578,0
468079,0,False,False,1459972105,1459972105,2579,0
468080,0,False,False,1451578985,1451578985,2580,0
468081,0,False,False,1464600182,1464600182,2582,0
468082,0,False,False,1458833197,1458833197,2583,0
468131,0,False,False,1467196544,1467196544,2586,0
468132,0,False,False,1452025086,1452025086,2587,0
468133,0,False,False,1467914022,1467914022,2588,0
468170,0,False,False,1449526605,1449526605,2591,0
468171,0,False,False,1461830207,1461830207,2592,0
468172,0,False,False,1467634771,1467634771,2593,0
468173,0,False,False,1468608435,1468608435,2594,0
468174,0,False,False,1455316859,1455316859,2595,0
468175,0,False,False,1460003043,1460003043,2596,0
468176,0,False,False,1477524761,1477524761,2597,0
468177,0,False,False,1450120931,1450120931,2598,0
468188,0,False,False,1463179165,1463179165,2601,0
468189,0,False,False,1467607241,1467607241,2602,0
468234,0,False,False,1470614673,1470614673,2604,0
468235,0,False,False,1452827866,1452827866,2605,0
468236,0,False,False,1467959194,1467959194,2606,0
468237,0,False,False,1453934801,1453934801,2607,0
468238,0,False,False,1467045582,1467045582,2608,0
468239,0,False,False,1463395128,1463395128,2609,0
468240,0,False,False,1461267492,1461267492,2611,0
468378,0,False,False,1478121287,1478121287,2615,0
468379,0,False,False,1482961997,1482961997,2616,0
468380,0,False,False,1457284725,1457284725,2617,0
468381,0,False,False,1465199004,1465199004,2618,0
468383,0,False,False,1451682805,1451682805,2620,0
468384,0,False,False,1462552049,1462552049,2621,0
468385,0,False,False,1453736410,1453736410,2622,0
468386,0,False,False,1478268479,1478268479,2624,0
468387,0,False,False,1461539087,1461539087,2625,0
468388,0,False,False,1454206616,1454206616,2626,0
468389,0,False,False,1458907233,1458907233,2627,0
468390,0,False,False,1450209655,1450209655,2628,0
468391,0,False,False,1453646203,1453646203,2629,0
468394,0,False,False,1453110546,1453110546,2631,0
468395,0,False,False,1451642216,1451642216,2632,0
468396,0,False,False,1472492514,1472492514,2633,0
468397,0,False,False,1470394860,1470394860,2634,0
468398,0,False,False,1457882193,1457882193,2635,0
468399,0,False,False,1460819333,1460819333,2636,0
468400,0,False,False,1474481032,1474481032,2638,0
468401,0,False,False,1454458513,1454458513,2640,0
468402,0,False,False,1463047739,1463047739,2642,0
468403,0,False,False,1476664507,1476664507,2644,0
468407,0,False,False,1472668101,1472668101,2646,0
468411,0,False,False,1459174909,1459174909,2648,0
468412,0,False,False,1472430614,1472430614,2649,0
468413,0,False,False,1458171025,1458171025,2650,0
468414,0,False,False,1468309654,1468309654,2651,0
468415,0,False,False,1461458868,1461458868,2652,0
468416,0,False,False,1454850634,1454850634,2653,0
468417,0,False,False,1469132596,1469132596,2654,0
468418,0,False,False,1472490790,1472490790,2655,0
468419,0,False,False,1452876784,1452876784,2657,0
468420,0,False,False,1453754011,1453754011,2658,0
468421,0,False,False,1454414972,1454414972,2659,0
468423,0,False,False,1465412972,1465412972,2661,0
468424,0,False,False,1480315252,1480315252,2662,0
468425,0,False,False,1476715145,1476715145,2664,0
468426,0,False,False,1477687193,1477687193,2665,0
468427,0,False,False,1473723264,1473723264,2666,0
468428,0,False,False,1452771602,1452771602,2667,0
468429,0,False,False,1453568008,1453568008,2668,0
468430,0,False,False,1469066405,1469066405,2669,0
468431,0,False,False,1462374790,1462374790,2670,0
468432,0,False,False,1464265553,1464265553,2671,0
468433,0,False,False,1473724647,1473724647,2672,0
468434,0,False,False,1461104350,1461104350,2673,0
468435,0,False,False,1458638859,1458638859,2674,0
468436,0,False,False,1465880859,1465880859,2675,0
468443,0,False,False,1465319435,1465319435,2677,0
468444,0,False,False,1464904742,1464904742,2679,0
495609,0,False,False,1462464792,1462464792,2681,0
495610,0,False,False,1474590789,1474590789,2682,0
495611,0,False,False,1456539385,1456539385,2684,0
495714,0,False,False,1452750473,1452750473,2686,0
495715,0,False,False,1460958798,1460958798,2687,0
495716,0,False,False,1469967483,1469967483,2688,0
495717,0,False,False,1465541489,1465541489,2691,0
495742,0,False,False,1469765676,1469765676,2693,0
495746,0,False,False,1466194325,1466194325,2695,0
495747,0,False,False,1449556256,1449556256,2696,0
495748,0,False,False,1467911810,1467911810,2697,0
495749,0,False,False,1460663037,1460663037,2698,0
495750,0,False,False,1451582148,1451582148,2699,0
495751,0,False,False,1475362283,1475362283,2700,0
495752,0,False,False,1475259860,1475259860,2701,0
495753,0,False,False,1462814770,1462814770,2702,0
495754,0,False,False,1478463243,1478463243,2703,0
495763,0,False,False,1451321176,1451321176,2706,0
495764,0,False,False,1481989333,1481989333,2707,0
495765,0,False,False,1451316712,1451316712,2709,0
495766,0,False,False,1472318176,1472318176,2710,0
495771,0,False,False,1461961693,1461961693,2713,0
495772,0,False,False,1464626349,1464626349,2714,0
495773,0,False,False,1459769721,1459769721,2717,0
495774,0,False,False,1464275916,1464275916,2718,0
495775,0,False,False,1461393077,1461393077,2719,0
495778,0,False,False,1474261801,1474261801,2721,0
495779,0,False,False,1457098227,1457098227,2722,0
495780,0,False,False,1450805262,1450805262,2723,0
495787,0,False,False,1454948256,1454948256,2725,0
495788,0,False,False,1476915000,1476915000,2726,0
495789,0,False,False,1466017274,1466017274,2727,0
495790,0,False,False,1472400518,1472400518,2728,0
495791,0,False,False,1464081029,1464081029,2729,0
495792,0,False,False,1474270477,1474270477,2730,0
495818,0,False,False,1469180706,1469180706,2733,0
495819,0,False,False,1454009678,1454009678,2735,0
496582,0,False,False,1461856703,1461856703,2737,0
496583,0,False,False,1462020398,1462020398,2738,0
496584,0,False,False,1469120514,1469120514,2739,0
496585,0,False,False,1478650425,1478650425,2740,0
496586,0,False,False,1472323769,1472323769,2741,0
496587,0,False,False,1465686557,1465686557,2742,0
496588,0,False,False,1469928497,1469928497,2743,0
496589,0,False,False,1479540571,1479540571,2744,0
496590,0,False,False,1466526377,1466526377,2745,0
496591,0,False,False,1475592075,1475592075,2746,0
496592,0,False,False,1475291460,1475291460,2747,0
496593,0,False,False,1470813559,1470813559,2748,0
496648,0,False,False,1455896204,1455896204,2750,0
496649,0,False,False,1478481422,1478481422,2751,0
496650,0,False,False,1481744490,1481744490,2752,0
496651,0,False,False,1477770996,1477770996,2753,0
496652,0,False,False,1457439505,1457439505,2754,0
496653,0,False,False,1476630767,1476630767,2755,0
496657,0,False,False,1482114202,1482114202,2757,0
496658,0,False,False,1459631172,1459631172,2758,0
496659,0,False,False,1467076049,1467076049,2759,0
496671,0,False,False,1461331931,1461331931,2763,0
496672,0,False,False,1467314180,1467314180,2764,0
496673,0,False,False,1481425465,1481425465,2765,0
496674,0,False,False,1450898588,1450898588,2766,0
496675,0,False,False,1472927319,1472927319,2767,0
496676,0,False,False,1451676862,1451676862,2768,0
496677,0,False,False,1481054550,1481054550,2769,0
496688,0,False,False,1474205235,1474205235,2771,0
496689,0,False,False,1465606332,1465606332,2772,0
496690,0,False,False,1455646604,1455646604,2773,0
496691,0,False,False,1470587027,1470587027,2774,0
496692,0,False,False,1449784771,1449784771,2775,0
496708,0,False,False,1467974116,1467974116,2780,0
496709,0,False,False,1455579240,1455579240,2781,0
496710,0,False,False,1458102194,1458102194,2782,0
496712,0,False,False,1461648408,1461648408,2784,0
496713,0,False,False,1455899051,1455899051,2786,0
496714,0,False,False,1479220928,1479220928,2787,0
496715,0,False,False,1461172751,1461172751,2788,0
496716,0,False,False,1473267996,1473267996,2789,0
496717,0,False,False,1466456052,1466456052,2792,0
496718,0,False,False,1449549719,1449549719,2793,0
496719,0,False,False,1476517719,1476517719,2794,0
496731,0,False,False,1461792215,1461792215,2796,0
496732,0,False,False,1450556808,1450556808,2797,0
496733,0,False,False,1475268495,1475268495,2798,0
496734,0,False,False,1455745178,1455745178,2799,0
496736,0,False,False,1483113217,1483113217,2801,0
497656,0,False,False,1474491281,1474491281,2804,0
497657,0,False,False,1478435900,1478435900,2805,0
497658,0,False,False,1482465379,1482465379,2807,0
497676,0,False,False,1474309746,1474309746,2811,0
497677,0,False,False,1463398700,1463398700,2812,0
497678,0,False,False,1455559081,1455559081,2815,0
498150,0,False,False,1469466183,1469466183,2819,0
498151,0,False,False,1452122547,1452122547,2820,0
498152,0,False,False,1483048157,1483048157,2821,0
498153,0,False,False,1449692571,1449692571,2823,0
498154,0,False,False,1457022729,1457022729,2824,0
498158,0,False,False,1465329207,1465329207,2828,0
498213,0,False,False,1454133969,1454133969,2830,0
498214,0,False,False,1458668696,1458668696,2831,0
498215,0,False,False,1457272778,1457272778,2832,0
498216,0,False,False,1454522520,1454522520,2834,0
498217,0,False,False,1456622518,1456622518,2835,0
498229,0,False,False,1450356286,1450356286,2837,0
498230,0,False,False,1465492677,1465492677,2838,0
498231,0,False,False,1457526830,1457526830,2839,0
498233,0,False,False,1449736022,1449736022,2841,0
498234,0,False,False,1472332748,1472332748,2842,0
498242,0,False,False,1472050720,1472050720,2844,0
498243,0,False,False,1469211804,1469211804,2845,0
498244,0,False,False,1472715583,1472715583,2846,0
498245,0,False,False,1452841755,1452841755,2847,0
498246,0,False,False,1455003284,1455003284,2848,0
498247,0,False,False,1454374254,1454374254,2849,0
498248,0,False,False,1471295460,1471295460,2850,0
498262,0,False,False,1460940938,1460940938,2854,0
498263,0,False,False,1467159151,1467159151,2855,0
498264,0,False,False,1463268626,1463268626,2856,0
498265,0,False,False,1464820619,1464820619,2857,0
498266,0,False,False,1451157046,1451157046,2858,0
498267,0,False,False,1456078668,1456078668,2859,0
498268,0,False,False,1479915917,1479915917,2860,0
498269,0,False,False,1449001733,1449001733,2861,0
498270,0,False,False,1470523269,1470523269,2862,0
498271,0,False,False,1475354741,1475354741,2863,0
498291,0,False,False,1452245993,1452245993,2865,0
498296,0,False,False,1478701429,1478701429,2867,0
498297,0,False,False,1454718633,1454718633,2869,0
498298,0,False,False,1469113993,1469113993,2870,0
498299,0,False,False,1470592948,1470592948,2871,0
498300,0,False,False,1466774041,1466774041,2872,0
498301,0,False,False,1473382262,1473382262,2875,0
498302,0,False,False,1479669348,1479669348,2876,0
498471,0,False,False,1451520846,1451520846,2881,0
498475,0,False,False,1460387986,1460387986,2883,0
498482,0,False,False,1450277091,1450277091,2886,0
498485,0,False,False,1482881524,1482881524,2888,0
498486,0,False,False,1475503400,1475503400,2890,0
498487,0,False,False,1453140914,1453140914,2891,0
498488,0,False,False,1465418137,1465418137,2892,0
498489,0,False,False,1463269346,1463269346,2893,0
498490,0,False,False,1475012573,1475012573,2894,0
498491,0,False,False,1455633012,1455633012,2895,0
498494,0,False,False,1465071683,1465071683,2898,0
498495,0,False,False,1462452171,1462452171,2900,0
498496,0,False,False,1474295818,1474295818,2901,0
498497,0,False,False,1467077800,1467077800,2902,0
498498,0,False,False,1467642218,1467642218,2903,0
498499,0,False,False,1460336708,1460336708,2904,0
498500,0,False,False,1477685610,1477685610,2905,0
498642,0,False,False,1462143352,1462143352,2908,0
498643,0,False,False,1456156652,1456156652,2909,0
498644,0,False,False,1478099776,1478099776,2910,0
498645,0,False,False,1482762018,1482762018,2911,0
498680,0,False,False,1453233815,1453233815,2915,0
498703,0,False,False,1452523139,1452523139,2922,0
498765,0,False,False,1452375311,1452375311,2931,0
498766,0,False,False,1461638638,1461638638,2932,0
499523,0,False,False,1472260631,1472260631,2936,0
499524,0,False,False,1479686231,1479686231,2937,0
499525,0,False,False,1463010760,1463010760,2938,0
499528,0,False,False,1462906821,1462906821,2941,0
499530,0,False,False,1454162859,1454162859,2943,0
499927,0,False,False,1450783486,1450783486,2945,0
499928,0,False,False,1481265284,1481265284,2946,0
499929,0,False,False,1482477914,1482477914,2947,0
499930,0,False,False,1479139146,1479139146,2948,0
499931,0,False,False,1468889845,1468889845,2949,0
499932,0,False,False,1471311083,1471311083,2950,0
499933,0,False,False,1460302807,1460302807,2951,0
499934,0,False,False,1454955130,1454955130,2952,0
499935,0,False,False,1455483734,1455483734,2953,0
499936,0,False,False,1463872049,1463872049,2954,0
499952,0,False,False,1465330812,1465330812,2957,0
499953,0,False,False,1480921162,1480921162,2959,0
499954,0,False,False,1471305489,1471305489,2960,0
499955,0,False,False,1455475983,1455475983,2961,0
500011,0,False,False,1474958762,1474958762,2964,0
500049,0,False,False,1465496918,1465496918,2967,0
500050,0,False,False,1480691480,1480691480,2968,0
500051,0,False,False,1463582051,1463582051,2969,0
500133,0,False,False,1455888461,1455888461,2972,0
500197,0,False,False,1478622932,1478622932,2974,0
500198,0,False,False,1472231803,1472231803,2975,0
500199,0,False,False,1476206474,1476206474,2976,0
500200,0,False,False,1451298704,1451298704,2977,0
500201,0,False,False,1471285361,1471285361,2978,0
500203,0,False,False,1462638687,1462638687,2980,0
500204,0,False,False,1456174144,1456174144,2982,0
500205,0,False,False,1461960837,1461960837,2983,0
500206,0,False,False,1476213434,1476213434,2984,0
500211,0,False,False,1453477104,1453477104,2986,0
500212,0,False,False,1468797372,1468797372,2987,0
500213,0,False,False,1449246018,1449246018,2988,0
500276,0,False,False,1466078780,1466078780,2990,0
500277,0,False,False,1474767725,1474767725,2991,0
500278,0,False,False,1456888309,1456888309,2992,0
500284,0,False,False,1469805473,1469805473,2994,0
500285,0,False,False,1455113465,1455113465,2997,0
500286,0,False,False,1451470831,1451470831,2999,0
500287,0,False,False,1463126582,1463126582,3000,0
500288,0,False,False,1478092391,1478092391,3001,0
500289,0,False,False,1473883792,1473883792,3002,0
500293,0,False,False,1474726221,1474726221,3004,0
500294,0,False,False,1468952539,1468952539,3005,0
500295,0,False,False,1471036820,1471036820,3008,0
500296,0,False,False,1471036820,1471036820,3009,0
500301,0,False,False,1452030277,1452030277,3012,0
500302,0,False,False,1479673815,1479673815,3014,0
500303,0,False,False,1456580774,1456580774,3015,0
500304,0,False,False,1451493698,1451493698,3017,0
500327,0,False,False,1471101735,1471101735,3020,0
500328,0,False,False,1477087010,1477087010,3021,0
500329,0,False,False,1472305464,1472305464,3022,0
500330,0,False,False,1453288342,1453288342,3023,0
500331,0,False,False,1454201827,1454201827,3024,0
500332,0,False,False,1453230197,1453230197,3025,0
500333,0,False,False,1461182609,1461182609,3027,0
500334,0,False,False,1462236775,1462236775,3028,0
500336,0,False,False,1468738821,1468738821,3031,0
502080,0,False,False,1459198916,1459198916,3033,0
502081,0,False,False,1454074689,1454074689,3035,0
502082,0,False,False,1472228001,1472228001,3038,0
502095,0,False,False,1463331289,1463331289,3040,0
502096,0,False,False,1464991217,1464991217,3041,0
502097,0,False,False,1459155324,1459155324,3042,0
502098,0,False,False,1470155898,1470155898,3043,0
502099,0,False,False,1464904329,1464904329,3044,0
502100,0,False,False,1473331748,1473331748,3045,0
502153,0,False,False,1451231754,1451231754,3047,0
502154,0,False,False,1463661270,1463661270,3048,0
502253,0,False,False,1455227918,1455227918,3051,0
502254,0,False,False,1478453796,1478453796,3052,0
502255,0,False,False,1472307532,1472307532,3053,0
502256,0,False,False,1457467328,1457467328,3054,0
502257,0,False,False,1478735252,1478735252,3055,0
502258,0,False,False,1467248444,1467248444,3056,0
502259,0,False,False,1473529839,1473529839,3057,0
502260,0,False,False,1466667108,1466667108,3058,0
502469,0,False,False,1480976581,1480976581,3061,0
502470,0,False,False,1457225433,1457225433,3062,0
502471,0,False,False,1463725692,1463725692,3063,0
502472,0,False,False,1457113675,1457113675,3064,0
502478,0,False,False,1464327583,1464327583,3066,0
502479,0,False,False,1476886530,1476886530,3067,0
502480,0,False,False,1451496147,1451496147,3068,0
502483,0,False,False,1473474896,1473474896,3070,0
502484,0,False,False,1473662079,1473662079,3071,0
502485,0,False,False,1458172390,1458172390,3072,0
502486,0,False,False,1482056143,1482056143,3073,0
502487,0,False,False,1455997576,1455997576,3074,0
502488,0,False,False,1461537350,1461537350,3075,0
502489,0,False,False,1456711017,1456711017,3077,0
502490,0,False,False,1483118175,1483118175,3078,0
502509,0,False,False,1470599702,1470599702,3081,0
502510,0,False,False,1457699991,1457699991,3083,0
502511,0,False,False,1481719969,1481719969,3084,0
502512,0,False,False,1480944252,1480944252,3085,0
502513,0,False,False,1452197414,1452197414,3086,0
502514,0,False,False,1474179244,1474179244,3087,0
502517,0,False,False,1470068402,1470068402,3089,0
502519,0,False,False,1456079881,1456079881,3091,0
502520,0,False,False,1478704815,1478704815,3093,0
502521,0,False,False,1462383199,1462383199,3094,0
502522,0,False,False,1460502437,1460502437,3095,0
502523,0,False,False,1468167028,1468167028,3096,0
502524,0,False,False,1456788082,1456788082,3097,0
502525,0,False,False,1460421752,1460421752,3098,0
502526,0,False,False,1456328835,1456328835,3099,0
502527,0,False,False,1461522188,1461522188,3100,0
502531,0,False,False,1451226552,1451226552,3103,0
502532,0,False,False,1454529863,1454529863,3104,0
502533,0,False,False,1474358184,1474358184,3105,0
503245,0,False,False,1465312243,1465312243,3108,0
503246,0,False,False,1469570330,1469570330,3109,0
503247,0,False,False,1450335025,1450335025,3110,0
503248,0,False,False,1464705221,1464705221,3111,0
503251,0,False,False,1475468778,1475468778,3114,0
503252,0,False,False,1474138545,1474138545,3115,0
503356,0,False,False,1465155277,1465155277,3117,0
503357,0,False,False,1460130418,1460130418,3118,0
503358,0,False,False,1460642702,1460642702,3119,0
503359,0,False,False,1467082743,1467082743,3120,0
503360,0,False,False,1454441948,1454441948,3121,0
503361,0,False,False,1453168928,1453168928,3123,0
503362,0,False,False,1453440312,1453440312,3124,0
503363,0,False,False,1470116528,1470116528,3125,0
503364,0,False,False,1473432058,1473432058,3126,0
503365,0,False,False,1456489413,1456489413,3127,0
503366,0,False,False,1469232533,1469232533,3128,0
503367,0,False,False,1458075316,1458075316,3129,0
503368,0,False,False,1452782554,1452782554,3130,0
503369,0,False,False,1471734393,1471734393,3131,0
503370,0,False,False,1473565902,1473565902,3132,0
503372,0,False,False,1481419174,1481419174,3134,0
503373,0,False,False,1467546908,1467546908,3135,0
503374,0,False,False,1464944044,1464944044,3138,0
503375,0,False,False,1456948014,1456948014,3139,0
503411,0,False,False,1475697403,1475697403,3141,0
503412,0,False,False,1466435969,1466435969,3144,0
503413,0,False,False,1459426419,1459426419,3146,0
503414,0,False,False,1449108544,1449108544,3147,0
503415,0,False,False,1455145385,1455145385,3148,0
503416,0,False,False,1461546454,1461546454,3149,0
503417,0,False,False,1464515810,1464515810,3150,0
503422,0,False,False,1482769123,1482769123,3153,0
517320,0,False,False,1476663035,1476663035,3156,0
517551,0,False,False,1449520104,1449520104,3158,0
517552,0,False,False,1470812454,1470812454,3159,0
517553,0,False,False,1453179328,1453179328,3160,0
517554,0,False,False,1470861183,1470861183,3162,0
518935,0,False,False,1470785092,1470785092,3165,0
519942,0,False,False,1469807244,1469807244,3168,0
519943,0,False,False,1476130763,1476130763,3170,0
519944,0,False,False,1451576936,1451576936,3171,0
519945,0,False,False,1457403684,1457403684,3173,0
519952,0,False,False,1451175117,1451175117,3177,0
520009,0,False,False,1450307459,1450307459,3179,0
520730,0,False,False,1470595422,1470595422,3183,0
520731,0,False,False,1456622912,1456622912,3184,0
520732,0,False,False,1466743370,1466743370,3185,0
520733,0,False,False,1458156722,1458156722,3186,0
520734,0,False,False,1466041602,1466041602,3187,0
520735,0,False,False,1466175001,1466175001,3188,0
520736,0,False,False,1474502324,1474502324,3190,0
520737,0,False,False,1451632766,1451632766,3191,0
520740,0,False,False,1469028672,1469028672,3193,0
520741,0,False,False,1468948214,1468948214,3194,0
520742,0,False,False,1464739917,1464739917,3195,0
520761,0,False,False,1457738465,1457738465,3197,0
520762,0,False,False,1468087447,1468087447,3198,0
520763,0,False,False,1478965045,1478965045,3199,0
520764,0,False,False,1452893536,1452893536,3200,0
520765,0,False,False,1460906315,1460906315,3201,0
520766,0,False,False,1459713769,1459713769,3202,0
520767,0,False,False,1457922261,1457922261,3203,0
520768,0,False,False,1473281072,1473281072,3204,0
520769,0,False,False,1460563376,1460563376,3205,0
520770,0,False,False,1461447925,1461447925,3206,0
520774,0,False,False,1465524132,1465524132,3208,0
520778,0,False,False,1476495276,1476495276,3211,0
520830,0,False,False,1462146134,1462146134,3215,0
520832,0,False,False,1478356530,1478356530,3217,0
520834,0,False,False,1457462771,1457462771,3219,0
520835,0,False,False,1454978007,1454978007,3220,0
520836,0,False,False,1475205143,1475205143,3221,0
520837,0,False,False,1482446130,1482446130,3222,0
520838,0,False,False,1451543539,1451543539,3223,0
520839,0,False,False,1457471235,1457471235,3224,0
520894,0,False,False,1479154683,1479154683,3228,0
520895,0,False,False,1471903588,1471903588,3229,0
520896,0,False,False,1471903588,1471903588,3230,0
520897,0,False,False,1464871995,1464871995,3231,0
520898,0,False,False,1452643379,1452643379,3232,0
520899,0,False,False,1472570640,1472570640,3233,0
520900,0,False,False,1479014179,1479014179,3234,0
520901,0,False,False,1451578039,1451578039,3236,0
520902,0,False,False,1476575129,1476575129,3237,0
520903,0,False,False,1482859366,1482859366,3238,0
521042,0,False,False,1471671458,1471671458,3240,0
521043,0,False,False,1467943382,1467943382,3241,0
521044,0,False,False,1461264499,1461264499,3242,0
521045,0,False,False,1456337811,1456337811,3243,0
521046,0,False,False,1452151501,1452151501,3244,0
521047,0,False,False,1461185384,1461185384,3245,0
521048,0,False,False,1456445650,1456445650,3246,0
521049,0,False,False,1467730632,1467730632,3248,0
521050,0,False,False,1476185613,1476185613,3249,0
521051,0,False,False,1469670472,1469670472,3250,0
521052,0,False,False,1462653550,1462653550,3251,0
521053,0,False,False,1467030620,1467030620,3252,0
521054,0,False,False,1465792443,1465792443,3253,0
521055,0,False,False,1453644969,1453644969,3254,0
521056,0,False,False,1456522568,1456522568,3255,0
521057,0,False,False,1453735899,1453735899,3256,0
521058,0,False,False,1455100548,1455100548,3257,0
521060,0,False,False,1458792807,1458792807,3259,0
521061,0,False,False,1456258248,1456258248,3260,0
521062,0,False,False,1474781710,1474781710,3261,0
521063,0,False,False,1451746791,1451746791,3262,0
521064,0,False,False,1460600927,1460600927,3263,0
521065,0,False,False,1461603525,1461603525,3264,0
521066,0,False,False,1473006421,1473006421,3265,0
521067,0,False,False,1449280338,1449280338,3267,0
521068,0,False,False,1466428128,1466428128,3268,0
521069,0,False,False,1459694617,1459694617,3270,0
521070,0,False,False,1470332475,1470332475,3271,0
521075,0,False,False,1474159391,1474159391,3273,0
521077,0,False,False,1455459624,1455459624,3275,0
521078,0,False,False,1475202684,1475202684,3276,0
521079,0,False,False,1459517762,1459517762,3277,0
521080,0,False,False,1482309311,1482309311,3278,0
521081,0,False,False,1461623729,1461623729,3279,0
521082,0,False,False,1456041828,1456041828,3280,0
521101,0,False,False,1475660189,1475660189,3282,0
521102,0,False,False,1475660189,1475660189,3283,0
521103,0,False,False,1457093310,1457093310,3284,0
521104,0,False,False,1470153452,1470153452,3285,0
521105,0,False,False,1455045472,1455045472,3286,0
521106,0,False,False,1483233409,1483233409,3288,0
521107,0,False,False,1477196128,1477196128,3289,0
521108,0,False,False,1467942109,1467942109,3290,0
521109,0,False,False,1453655226,1453655226,3291,0
521110,0,False,False,1453334611,1453334611,3292,0
521111,0,False,False,1454948971,1454948971,3294,0
521112,0,False,False,1458634048,1458634048,3295,0
521120,0,False,False,1463972939,1463972939,3297,0
521121,0,False,False,1472010820,1472010820,3298,0
521124,0,False,False,1468422180,1468422180,3300,0
521125,0,False,False,1452119101,1452119101,3302,0
521126,0,False,False,1457025696,1457025696,3303,0
521127,0,False,False,1453408980,1453408980,3304,0
521139,0,False,False,1479329344,1479329344,3306,0
521140,0,False,False,1456750007,1456750007,3307,0
521141,0,False,False,1473940472,1473940472,3308,0
521142,0,False,False,1474050806,1474050806,3309,0
521144,0,False,False,1477419497,1477419497,3311,0
521145,0,False,False,1454968806,1454968806,3312,0
521147,0,False,False,1477662930,1477662930,3314,0
521813,0,False,False,1457270069,1457270069,3316,0
521820,0,False,False,1451866660,1451866660,3319,0
521821,0,False,False,1461049535,1461049535,3320,0
521823,0,False,False,1452630098,1452630098,3322,0
521824,0,False,False,1467511346,1467511346,3323,0
521825,0,False,False,1457456971,1457456971,3324,0
521826,0,False,False,1455580381,1455580381,3325,0
521827,0,False,False,1467715780,1467715780,3326,0
521828,0,False,False,1453641185,1453641185,3327,0
521830,0,False,False,1465246296,1465246296,3329,0
521831,0,False,False,1458675440,1458675440,3330,0
521832,0,False,False,1470774927,1470774927,3331,0
521833,0,False,False,1460436856,1460436856,3332,0
521834,0,False,False,1456388606,1456388606,3333,0
521835,0,False,False,1460662914,1460662914,3334,0
521836,0,False,False,1460662914,1460662914,3335,0
521837,0,False,False,1461696999,1461696999,3336,0
521838,0,False,False,1468122268,1468122268,3337,0
522271,0,False,False,1476359863,1476359863,3341,0
522272,0,False,False,1468891314,1468891314,3342,0
522273,0,False,False,1481838763,1481838763,3343,0
522295,0,False,False,1457384028,1457384028,3345,0
522297,0,False,False,1470994386,1470994386,3347,0
522298,0,False,False,1470994386,1470994386,3348,0
522299,0,False,False,1470335021,1470335021,3349,0
522305,0,False,False,1451362636,1451362636,3351,0
522306,0,False,False,1473521309,1473521309,3352,0
522307,0,False,False,1455132346,1455132346,3353,0
522308,0,False,False,1472413571,1472413571,3354,0
522364,0,False,False,1465591816,1465591816,3358,0
522365,0,False,False,1475771799,1475771799,3359,0
522371,0,False,False,1463855989,1463855989,3362,0
522372,0,False,False,1455158945,1455158945,3363,0
522373,0,False,False,1468046948,1468046948,3364,0
522374,0,False,False,1452361141,1452361141,3365,0
522375,0,False,False,1457017072,1457017072,3366,0
522387,0,False,False,1483119647,1483119647,3368,0
522388,0,False,False,1461257294,1461257294,3369,0
522389,0,False,False,1457204670,1457204670,3370,0
522390,0,False,False,1449700034,1449700034,3371,0
522391,0,False,False,1463147133,1463147133,3372,0
522392,0,False,False,1472499963,1472499963,3373,0
