,sub_comment_index,count,is_written_in_last_month,is_written_in_last_week,max_created_utc,referral_utc,time_since_last_post
4,1464547697,15,TRUE,TRUE,1464541699,1464547697,5998
19,1478588539,7,FALSE,FALSE,1450966590,1478588539,27621949
31,1465075160,2,TRUE,FALSE,1463448719,1465075160,1626441
34,1452029188,712,TRUE,TRUE,1451962886,1452029188,66302
748,1478598372,1,TRUE,TRUE,1478586993,1478598372,11379
751,1476936098,1,TRUE,TRUE,1476890428,1476936098,45670
752,1476935497,1,TRUE,TRUE,1476890428,1476935497,45069
753,1473633197,35,TRUE,TRUE,1473617941,1473633197,15256
788,1478629588,90,TRUE,FALSE,1477061806,1478629588,1567782
887,10,7,TRUE,FALSE,1474535465,1475561438,1025973
899,16,726,TRUE,FALSE,1453343958,1454607188,1263230
1625,17,1,TRUE,FALSE,1479276880,1480168881,892001
1629,21,1,TRUE,FALSE,1451021115,1452373210,1352095
1632,24,33802,TRUE,TRUE,1475761423,1475761954,531
35438,31,5,TRUE,TRUE,1477674817,1477697610,22793
35445,35,1,FALSE,FALSE,1470187910,1473899867,3711957
35452,43,1,TRUE,TRUE,1465419178,1465762851,343673
35453,44,1,TRUE,FALSE,1470498649,1471319355,820706
35464,56,178,TRUE,TRUE,1467776820,1468266920,490100
35646,62,2993,TRUE,TRUE,1478534340,1478535195,855
38640,65,1652,TRUE,TRUE,1480619452,1480642460,23008
40292,66,6,FALSE,FALSE,1433116642,1452285327,19168685
40298,67,2,TRUE,TRUE,1478896701,1478902696,5995
40301,70,711,TRUE,TRUE,1451749594,1451845514,95920
41018,79,10,FALSE,FALSE,1471521823,1477928000,6406177
41035,88,7,FALSE,FALSE,1450966590,1478641092,27674502
41046,94,10,FALSE,FALSE,1453315725,1457024577,3708852
41057,96,2,TRUE,TRUE,1466428949,1466435892,6943
41065,105,17,TRUE,FALSE,1468002810,1470445085,2442275
41083,107,14,TRUE,FALSE,1472557061,1473624674,1067613
41097,108,12,FALSE,FALSE,1456321329,1465473080,9151751
41111,112,711,TRUE,TRUE,1451749594,1451794896,45302
41822,113,697,TRUE,TRUE,1451401920,1451490951,89031
42520,115,2,FALSE,FALSE,1468826737,1472849075,4022338
42522,116,4,FALSE,FALSE,1442603045,1452474477,9871432
42526,117,41,FALSE,FALSE,1472580858,1480284262,7703404
42568,119,73,TRUE,TRUE,1479821667,1479822324,657
42645,124,1,FALSE,FALSE,1469830825,1476462607,6631782
42647,126,1,TRUE,TRUE,1453260444,1453260844,400
42657,139,758,TRUE,TRUE,1460147630,1460405879,258249
43421,146,12,TRUE,FALSE,1476653596,1478491336,1837740
43434,148,575,TRUE,TRUE,1452279441,1452356072,76631
44010,152,1,TRUE,TRUE,1474574247,1475050234,475987
44011,154,2,FALSE,FALSE,1449594344,1472640403,23046059
44016,160,11,TRUE,TRUE,1474522206,1474598458,76252
44027,164,1,FALSE,FALSE,1440441934,1463698945,23257011
44031,169,450,TRUE,TRUE,1480417559,1480457539,39980
44484,173,2,TRUE,TRUE,1464935356,1465068857,133501
44493,182,602,TRUE,TRUE,1453561746,1453603125,41379
45097,186,2674,TRUE,TRUE,1473638414,1473707775,69361
47771,187,40,TRUE,FALSE,1474384222,1475300194,915972
47816,193,1,FALSE,FALSE,1427023089,1451995486,24972397
47818,195,8,TRUE,FALSE,1471612916,1473696308,2083392
47836,210,1,FALSE,FALSE,1432757350,1455754594,22997244
47840,215,6,TRUE,TRUE,1461363776,1461884946,521170
47846,216,7,FALSE,FALSE,1467362862,1471420614,4057752
47859,224,2,TRUE,FALSE,1451891385,1453048502,1157117
47864,228,29,TRUE,FALSE,1473863122,1474572778,709656
47895,231,2,FALSE,FALSE,1445268047,1451871617,6603570
47900,235,411,TRUE,TRUE,1452355354,1452384058,28704
48313,239,14,TRUE,TRUE,1464702898,1464704099,1201
48328,242,37,FALSE,FALSE,1472140092,1477571760,5431668
48370,250,4,FALSE,FALSE,1462407255,1472651716,10244461
48376,255,575,TRUE,TRUE,1452279441,1452354193,74752
48951,256,2144,TRUE,TRUE,1475318150,1475333469,15319
51097,259,1,TRUE,TRUE,1451677762,1452029686,351924
51101,264,8,TRUE,TRUE,1452020661,1452033380,12719
51110,266,1,TRUE,TRUE,1465419178,1465774659,355481
51119,276,680,TRUE,TRUE,1450873376,1450927447,54071
51807,285,41,TRUE,TRUE,1455514103,1455558167,44064
51848,286,1,TRUE,TRUE,1475516860,1475517565,705
51849,287,2,FALSE,FALSE,1450618262,1460643116,10024854
51851,288,1,TRUE,TRUE,1476890428,1476939017,48589
51852,289,5,TRUE,TRUE,1479493842,1479929323,435481
51858,292,5,TRUE,FALSE,1476939309,1477673653,734344
51864,294,1,TRUE,TRUE,1470934924,1470951070,16146
51865,295,1,TRUE,TRUE,1470934924,1470951070,16146
51866,296,3,TRUE,TRUE,1452012409,1452016377,3968
51872,301,689,TRUE,TRUE,1451274907,1451303697,28790
52568,309,1,TRUE,TRUE,1451900450,1452020180,119730
52573,314,5,FALSE,FALSE,1447881446,1463591246,15709800
52578,315,6,TRUE,TRUE,1467686325,1467852712,166387
52593,326,5,TRUE,TRUE,1454525061,1454535511,10450
52601,330,3,TRUE,TRUE,1472841392,1472914194,72802
52607,334,1,FALSE,FALSE,1425666844,1470087438,44420594
52608,335,1,FALSE,FALSE,1425666844,1470087438,44420594
52616,346,3058,TRUE,TRUE,1481561198,1481644195,82997
55682,357,2,TRUE,TRUE,1450927845,1450934745,6900
55694,375,2,TRUE,TRUE,1461314909,1461330062,15153
55696,376,36,TRUE,FALSE,1479238285,1480521249,1282964
55732,378,1,TRUE,TRUE,1470492440,1470517121,24681
55734,380,11,TRUE,TRUE,1461072856,1461175582,102726
55767,408,1,TRUE,TRUE,1474173001,1474204151,31150
55778,422,1,TRUE,TRUE,1466126662,1466127336,674
55783,428,25,TRUE,TRUE,1480576898,1480886052,309154
55809,430,1,FALSE,FALSE,1459030053,1482985145,23955092
55814,437,29412,TRUE,TRUE,1465833689,1465834128,439
85233,446,1,TRUE,TRUE,1472450497,1472472451,21954
85234,447,4,TRUE,TRUE,1459947859,1459974624,26765
85243,453,56047,TRUE,TRUE,1462801475,1462801674,199
141292,456,177,TRUE,TRUE,1463615276,1464040113,424837
141474,466,1,TRUE,TRUE,1454992584,1455046490,53906
141502,496,4,TRUE,TRUE,1459122376,1459438984,316608
141507,498,1,TRUE,TRUE,1461599427,1461684823,85396
141509,501,1,FALSE,FALSE,1448671192,1462660138,13988946
141510,502,1,FALSE,FALSE,1448671192,1462660138,13988946
141512,504,1,TRUE,TRUE,1469651197,1469651267,70
141522,516,5,FALSE,FALSE,1457563631,1470666568,13102937
141533,524,20,TRUE,TRUE,1472999552,1473500436,500884
141556,529,348,TRUE,TRUE,1467245533,1467246106,573
141904,530,3,FALSE,FALSE,1451826755,1456504602,4677847
141909,533,29,TRUE,TRUE,1466516056,1466561514,45458
141939,536,1,FALSE,FALSE,1451741711,1467981131,16239420
141952,550,2,TRUE,TRUE,1464453958,1464456439,2481
141957,556,25,TRUE,FALSE,1477068874,1477917743,848869
141986,562,12,FALSE,FALSE,1465140678,1470806312,5665634
142008,575,1,FALSE,FALSE,1431402756,1451393614,19990858
142019,588,1,TRUE,TRUE,1473330281,1473514832,184551
142021,590,879,TRUE,TRUE,1471021201,1471235175,213974
142910,601,3,TRUE,TRUE,1455064722,1455333436,268714
142923,612,7,TRUE,FALSE,1478624210,1480298695,1674485
142934,617,73058,TRUE,TRUE,1478547638,1478547867,229
215993,619,1,FALSE,FALSE,1427023089,1451984736,24961647
215997,625,5,FALSE,FALSE,1453824988,1479928453,26103465
216005,629,1,TRUE,TRUE,1480826961,1480830401,3440
216014,639,1,TRUE,TRUE,1466411725,1466942365,530640
216020,645,67,TRUE,TRUE,1471774464,1471792291,17827
216091,650,7,TRUE,TRUE,1471947147,1471980786,33639
216103,656,3,TRUE,TRUE,1473100562,1473218995,118433
216108,660,9,TRUE,FALSE,1453983855,1454787998,804143
216119,663,6,TRUE,TRUE,1454425680,1454722388,296708
216135,674,10,TRUE,FALSE,1453315725,1454907708,1591983
216148,678,4,FALSE,FALSE,1420806183,1472407720,51601537
216152,680,1,TRUE,FALSE,1476902613,1477590691,688078
216153,682,2,FALSE,FALSE,1429430173,1466040000,36609827
216157,686,1,FALSE,FALSE,1469660425,1472490367,2829942
216158,687,12,TRUE,FALSE,1448032294,1449589285,1556991
216190,711,91,TRUE,TRUE,1459854217,1459889104,34887
216282,713,7,TRUE,FALSE,1470243553,1471376208,1132655
216307,734,115,TRUE,TRUE,1476630771,1476718949,88178
216429,742,19,TRUE,FALSE,1481598123,1482422369,824246
216452,747,2,TRUE,TRUE,1448992859,1448993503,644
216458,752,4,TRUE,TRUE,1474952002,1474963965,11963
216463,754,1,FALSE,FALSE,1461729960,1468853308,7123348
216466,759,14,TRUE,TRUE,1467258582,1467263211,4629
216488,768,39,TRUE,TRUE,1449028259,1449029994,1735
216529,771,20,TRUE,TRUE,1454835643,1455299241,463598
216553,776,2,FALSE,FALSE,1448899745,1456069183,7169438
216556,778,5,FALSE,FALSE,1457102603,1464358300,7255697
216561,779,7,TRUE,TRUE,1466480129,1466514494,34365
216573,785,5,FALSE,FALSE,1452523961,1455640456,3116495
216579,788,8,TRUE,TRUE,1472601039,1472663525,62486
216588,791,6,TRUE,TRUE,1453710900,1453727718,16818
216594,792,4,TRUE,TRUE,1453267085,1453325521,58436
216599,794,2,TRUE,TRUE,1477418155,1477425246,7091
216613,808,1,TRUE,TRUE,1472046862,1472149588,102726
216615,810,1,TRUE,FALSE,1478387734,1479344383,956649
216616,811,94,TRUE,TRUE,1453460590,1453491220,30630
216710,812,4,TRUE,TRUE,1478314426,1478324503,10077
216720,821,88,TRUE,TRUE,1473607607,1473654925,47318
216812,827,1,TRUE,TRUE,1474484072,1474491527,7455
216813,828,1,TRUE,TRUE,1474484072,1474491527,7455
216831,849,7,FALSE,FALSE,1433424354,1482343581,48919227
216839,851,3,TRUE,TRUE,1476511417,1476858713,347296
216851,861,16,TRUE,TRUE,1471183108,1471356528,173420
216875,871,4,TRUE,TRUE,1466108164,1466117635,9471
216882,875,10,TRUE,TRUE,1451894553,1452290422,395869
216895,879,2,TRUE,TRUE,1473873601,1474193506,319905
216904,888,3,TRUE,TRUE,1473092263,1473111266,19003
216909,891,1,TRUE,TRUE,1474546337,1474555254,8917
216918,902,7,TRUE,TRUE,1451399490,1451399905,415
216929,908,1,TRUE,TRUE,1478268058,1478825788,557730
216933,912,2,FALSE,FALSE,1429375398,1456082472,26707074
216949,927,1,FALSE,FALSE,1440965056,1454268127,13303071
216965,947,5,FALSE,FALSE,1431439455,1459753046,28313591
216970,948,5,FALSE,FALSE,1431439455,1459753046,28313591
216976,950,52,TRUE,TRUE,1463565838,1463918452,352614
217035,960,3,FALSE,FALSE,1461722246,1465583877,3861631
217039,963,1,TRUE,TRUE,1475084937,1475097383,12446
217046,971,1284,TRUE,TRUE,1457289637,1457300360,10723
218334,976,5,TRUE,TRUE,1466487803,1466643093,155290
218348,986,1,FALSE,FALSE,1471305025,1474314649,3009624
218364,1004,2,TRUE,FALSE,1461482362,1462510711,1028349
218374,1019,1,FALSE,FALSE,1426588965,1461248000,34659035
218376,1021,1,TRUE,TRUE,1477052328,1477194377,142049
218377,1023,2,TRUE,FALSE,1450751757,1452533236,1781479
218381,1026,102,TRUE,TRUE,1456423855,1456423992,137
218491,1036,18,TRUE,TRUE,1454537852,1454649397,111545
218509,1037,62970,TRUE,TRUE,1468213388,1468215782,2394
281480,1039,9,TRUE,FALSE,1448906973,1449697299,790326
281502,1056,11,TRUE,TRUE,1461072856,1461347388,274532
281513,1057,2,TRUE,FALSE,1454257052,1455473534,1216482
281515,1058,2,TRUE,FALSE,1454257052,1455473534,1216482
281521,1065,53,TRUE,TRUE,1477465294,1477585528,120234
281576,1068,24,TRUE,TRUE,1461343484,1461422417,78933
281600,1069,1925,TRUE,TRUE,1451414665,1451479346,64681
283527,1075,13,FALSE,FALSE,1438856441,1455137318,16280877
283544,1080,2,TRUE,TRUE,1452621186,1452634596,13410
283556,1093,1,TRUE,TRUE,1479674096,1479676461,2365
283559,1098,3,TRUE,TRUE,1464685762,1464957477,271715
283562,1099,1,FALSE,FALSE,1462804000,1472923176,10119176
283565,1104,7,FALSE,FALSE,1455566760,1459940406,4373646
283577,1111,711,TRUE,TRUE,1451749594,1451794997,45403
284288,1112,63,TRUE,TRUE,1476797669,1476967188,169519
284353,1115,1,FALSE,FALSE,1453231169,1460721166,7489997
284356,1118,272,TRUE,TRUE,1451518740,1451542334,23594
284646,1141,1,TRUE,TRUE,1454124118,1454449325,325207
284656,1151,4,TRUE,TRUE,1451681608,1451683794,2186
284666,1162,2,TRUE,FALSE,1467083994,1469342134,2258140
284674,1171,2,FALSE,FALSE,1431475151,1451449160,19974009
284676,1172,8,FALSE,FALSE,1461782224,1467835215,6052991
284688,1177,1,FALSE,FALSE,1446330295,1460481027,14150732
284698,1188,3,TRUE,TRUE,1459694942,1459695367,425
284702,1190,2,TRUE,FALSE,1452061088,1452736413,675325
284704,1191,5,TRUE,FALSE,1480202176,1482126623,1924447
284725,1210,3,TRUE,FALSE,1452594488,1454388655,1794167
284730,1215,233,TRUE,TRUE,1462467798,1462470742,2944
284965,1218,50,TRUE,TRUE,1475373155,1475411577,38422
285016,1221,26,TRUE,FALSE,1475078301,1475899029,820728
285060,1242,3,TRUE,FALSE,1468698372,1469997791,1299419
285066,1247,5,FALSE,FALSE,1447382356,1452263089,4880733
285083,1266,73,TRUE,TRUE,1483022745,1483034134,11389
285162,1274,13,TRUE,TRUE,1472996319,1472997448,1129
285175,1275,2,TRUE,TRUE,1452128981,1452129399,418
285184,1285,54,TRUE,TRUE,1477440830,1477473722,32892
285240,1288,2,FALSE,FALSE,1444033485,1449316748,5283263
285252,1300,14,FALSE,FALSE,1459871231,1462590063,2718832
285271,1306,1,FALSE,FALSE,1448132470,1462669973,14537503
285285,1322,412,TRUE,TRUE,1452416609,1452421091,4482
285697,1323,14,TRUE,TRUE,1479515414,1479565722,50308
285714,1327,122,TRUE,TRUE,1459985722,1460212387,226665
285837,1330,54,TRUE,TRUE,1477440830,1477473674,32844
285902,1344,879,TRUE,TRUE,1482524162,1482525232,1070
286785,1350,2,TRUE,FALSE,1450751757,1452491513,1739756
286788,1352,29,TRUE,TRUE,1451652340,1451771944,119604
286830,1372,58,TRUE,TRUE,1454454997,1454458310,3313
286897,1382,2,TRUE,TRUE,1449338774,1449523777,185003
286908,1392,2,FALSE,FALSE,1466210294,1468842656,2632362
286914,1398,2,FALSE,FALSE,1444326943,1461819482,17492539
286920,1403,73,FALSE,FALSE,1455772682,1463955810,8183128
286993,1404,3,FALSE,FALSE,1453538679,1469219361,15680682
287002,1411,5,TRUE,TRUE,1456329279,1456347342,18063
287007,1412,9,TRUE,TRUE,1452814546,1452858224,43678
287018,1415,1,TRUE,FALSE,1449491023,1450878505,1387482
287019,1416,47,TRUE,TRUE,1451802626,1451975213,172587
287067,1418,22,TRUE,TRUE,1461683251,1462043926,360675
287089,1419,6,TRUE,FALSE,1461248133,1462771094,1522961
287108,1436,2,TRUE,TRUE,1475603736,1475659570,55834
287118,1445,98,TRUE,TRUE,1461938456,1462375484,437028
287217,1447,1,FALSE,FALSE,1433874567,1476375562,42500995
287218,1448,49,TRUE,TRUE,1479162751,1479180831,18080
287275,1457,50,TRUE,TRUE,1463990532,1464176269,185737
287329,1462,4,TRUE,TRUE,1480681638,1480908068,226430
287335,1465,17,TRUE,FALSE,1468002810,1470456434,2453624
287357,1472,35,TRUE,TRUE,1461658570,1461690955,32385
287403,1485,3,FALSE,FALSE,1441987670,1462800198,20812528
287410,1490,36,TRUE,TRUE,1461692218,1461725460,33242
287452,1497,5,TRUE,FALSE,1464064333,1465008285,943952
287459,1501,3,FALSE,FALSE,1440694735,1460557473,19862738
287466,1507,83,TRUE,TRUE,1452563951,1452567273,3322
287555,1516,5,FALSE,FALSE,1434631188,1467290700,32659512
287561,1518,1,TRUE,TRUE,1453897979,1453898308,329
287564,1522,36,TRUE,TRUE,1450933720,1451422379,488659
287600,1523,1,FALSE,FALSE,1450574134,1472606209,22032075
287602,1525,15,TRUE,TRUE,1458643428,1458755199,111771
287618,1527,1,TRUE,TRUE,1482740964,1482807367,66403
287628,1538,1,TRUE,TRUE,1474374994,1474541078,166084
287630,1540,153,TRUE,TRUE,1467371035,1467475364,104329
287783,1542,33,FALSE,FALSE,1456024693,1460780098,4755405
287821,1548,3,FALSE,FALSE,1469661228,1482858899,13197671
287838,1564,56628,TRUE,TRUE,1463158608,1463159121,513
344473,1572,11,FALSE,FALSE,1460437818,1464023077,3585259
344490,1579,3,TRUE,FALSE,1475884753,1476837178,952425
344495,1582,71,TRUE,TRUE,1479450974,1479475762,24788
344568,1585,7,TRUE,TRUE,1451600961,1451606878,5917
344582,1596,4,FALSE,FALSE,1457061519,1465582093,8520574
344591,1602,81,TRUE,TRUE,1482240867,1482334508,93641
344672,1603,9729,TRUE,TRUE,1475173765,1475175383,1618
354403,1606,585,TRUE,TRUE,1455490036,1455542621,52585
354994,1614,1,TRUE,TRUE,1479246989,1479249536,2547
355005,1627,3,TRUE,FALSE,1474987183,1477185092,2197909
355016,1637,3,FALSE,FALSE,1453147471,1456225607,3078136
355028,1652,5,TRUE,TRUE,1454185648,1454474290,288642
355033,1653,5,TRUE,TRUE,1454185648,1454474290,288642
355050,1668,16,FALSE,FALSE,1455396294,1459000380,3604086
355080,1685,12,TRUE,TRUE,1459283506,1459478287,194781
355095,1691,1,FALSE,FALSE,1437579232,1456326782,18747550
355099,1697,5,FALSE,FALSE,1427001518,1456831179,29829661
355105,1699,1,FALSE,FALSE,1421150106,1461513285,40363179
355107,1701,3,TRUE,TRUE,1462642972,1462725977,83005
355114,1706,23,TRUE,TRUE,1473043076,1473171863,128787
355138,1710,1,TRUE,TRUE,1476202279,1476209514,7235
355139,1711,3,FALSE,FALSE,1454727065,1457462976,2735911
355147,1718,3,TRUE,TRUE,1451252285,1451253808,1523
355163,1734,9,TRUE,TRUE,1457468464,1457544807,76343
355180,1745,11,TRUE,TRUE,1455635449,1455643049,7600
355202,1759,1,FALSE,FALSE,1466859083,1473417020,6557937
355207,1764,5,TRUE,TRUE,1476746679,1476761523,14844
355225,1782,11,FALSE,FALSE,1427679441,1469555102,41875661
355236,1783,27,TRUE,FALSE,1469468407,1470434278,965871
355265,1788,7,FALSE,FALSE,1435720117,1458103522,22383405
355280,1798,417,TRUE,TRUE,1451867868,1451899834,31966
355700,1802,937,TRUE,TRUE,1475586140,1475588285,2145
356638,1804,4,TRUE,TRUE,1449351586,1449361106,9520
356650,1813,3,TRUE,FALSE,1463119097,1464175631,1056534
356665,1829,1,TRUE,TRUE,1469062803,1469069348,6545
356668,1832,931,TRUE,TRUE,1475506706,1475513174,6468
357599,1835,40978,TRUE,TRUE,1452370378,1452371384,1006
398580,1839,29,TRUE,TRUE,1451652340,1451770316,117976
398624,1858,188,FALSE,FALSE,1452752262,1460776412,8024150
398814,1861,2,FALSE,FALSE,1455828516,1462318117,6489601
398824,1871,5,TRUE,TRUE,1451760336,1451797431,37095
398831,1875,3,TRUE,FALSE,1468799695,1469413620,613925
398834,1876,146,TRUE,TRUE,1481997264,1482224190,226926
398985,1882,830,TRUE,TRUE,1452358209,1452358317,108
399818,1887,5,TRUE,FALSE,1452121737,1453205434,1083697
399827,1892,2,TRUE,FALSE,1474063409,1475526325,1462916
399829,1893,54843,TRUE,TRUE,1461954340,1461955074,734
454672,1894,1,TRUE,FALSE,1451932623,1452610402,677779
454684,1907,1,TRUE,TRUE,1475084937,1475085684,747
454690,1913,39,TRUE,FALSE,1458704547,1459612812,908265
454734,1919,2,FALSE,FALSE,1445268047,1451946483,6678436
454742,1927,2,FALSE,FALSE,1429296813,1469917718,40620905
454744,1928,2,FALSE,FALSE,1468177630,1478024265,9846635
454752,1935,1,TRUE,TRUE,1466301148,1466356855,55707
454761,1946,1,FALSE,FALSE,1469020060,1474426619,5406559
454770,1955,2,TRUE,FALSE,1481254228,1482730385,1476157
454777,1962,1,TRUE,FALSE,1451021115,1452374737,1353622
454778,1963,88,TRUE,TRUE,1473607607,1473655096,47489
454867,1965,16,TRUE,TRUE,1453708816,1454087079,378263
454884,1967,12,TRUE,TRUE,1471744816,1472086904,342088
454900,1973,321,TRUE,TRUE,1480399460,1480445393,45933
455226,1980,1,TRUE,FALSE,1451951369,1453133976,1182607
455229,1983,3,TRUE,TRUE,1457036158,1457037686,1528
455236,1988,2,FALSE,FALSE,1463056445,1473269127,10212682
455250,2003,5,TRUE,TRUE,1466487803,1466642062,154259
455255,2004,1,FALSE,FALSE,1421150106,1461264611,40114505
455257,2007,19,TRUE,TRUE,1473894073,1473935241,41168
455283,2016,20,FALSE,FALSE,1455713858,1463584515,7870657
455309,2023,2,TRUE,TRUE,1452962582,1453165418,202836
455319,2034,88,TRUE,TRUE,1473607607,1473654805,47198
455409,2037,1,TRUE,TRUE,1481259999,1481689518,429519
455413,2041,247,TRUE,FALSE,1460009732,1461128885,1119153
455665,2047,18,FALSE,FALSE,1474603247,1477394314,2791067
455684,2049,5,FALSE,FALSE,1439593615,1454616229,15022614
455707,2074,1,TRUE,TRUE,1457360720,1457445669,84949
455717,2087,8,FALSE,FALSE,1453713240,1472144623,18431383
455725,2088,5,TRUE,FALSE,1458583182,1459451820,868638
455732,2091,3,TRUE,FALSE,1469414097,1470847055,1432958
455736,2093,3,TRUE,TRUE,1467606030,1467938185,332155
455742,2098,4,TRUE,TRUE,1459947859,1459979910,32051
455747,2100,15,TRUE,TRUE,1456273322,1456708345,435023
455768,2107,12,TRUE,TRUE,1474079183,1474079997,814
455780,2108,160,TRUE,FALSE,1457240149,1458587206,1347057
455940,2109,1,FALSE,FALSE,1438217829,1459490206,21272377
455943,2112,4,TRUE,FALSE,1451287244,1453066055,1778811
455965,2132,1,TRUE,TRUE,1475029644,1475061765,32121
455971,2139,1,TRUE,TRUE,1456883863,1456884872,1009
455981,2152,22,TRUE,TRUE,1452940638,1452964093,23455
456013,2164,3258,TRUE,TRUE,1463589789,1463593640,3851
459271,2165,711,TRUE,TRUE,1451749594,1451768205,18611
459990,2176,6,FALSE,FALSE,1457495952,1463127484,5631532
459998,2179,1,FALSE,FALSE,1446672993,1456261719,9588726
460001,2184,1407,TRUE,TRUE,1470489495,1470661119,171624
461409,2186,3,TRUE,TRUE,1450425491,1450425558,67
461415,2190,9,TRUE,TRUE,1452617991,1453146866,528875
461425,2196,1,TRUE,TRUE,1477526229,1477530411,4182
461426,2197,1,TRUE,TRUE,1477526229,1477530411,4182
461427,2200,1,TRUE,TRUE,1469342607,1469390017,47410
461428,2201,1,TRUE,TRUE,1469342607,1469390017,47410
461431,2204,3,FALSE,FALSE,1423508592,1456030734,32522142
461434,2205,3,FALSE,FALSE,1423508592,1456030734,32522142
461465,2236,32,FALSE,FALSE,1450834421,1459721367,8886946
461507,2250,1,TRUE,TRUE,1464042398,1464463344,420946
461528,2274,2,TRUE,FALSE,1460823824,1461563094,739270
461530,2275,2,TRUE,FALSE,1460823824,1461563094,739270
461542,2287,43,TRUE,TRUE,1455284665,1455301485,16820
461587,2290,1,TRUE,TRUE,1464323906,1464347415,23509
461592,2295,1,FALSE,FALSE,1445758034,1470349251,24591217
461593,2296,1,TRUE,FALSE,1480009991,1481717604,1707613
461595,2299,1909,TRUE,TRUE,1457210400,1457212559,2159
463507,2303,3,TRUE,FALSE,1455846315,1456631694,785379
463517,2313,5,TRUE,FALSE,1477866412,1480344399,2477987
463533,2326,1,TRUE,FALSE,1465638476,1466942014,1303538
463540,2336,1,TRUE,FALSE,1465501318,1468069652,2568334
463553,2352,1,TRUE,TRUE,1452813829,1452899636,85807
463555,2354,31,TRUE,TRUE,1473191874,1473225729,33855
463590,2359,3,FALSE,FALSE,1436517152,1460786753,24269601
463594,2361,1,TRUE,TRUE,1462908060,1462961730,53670
463604,2372,1639,TRUE,TRUE,1455911266,1455911408,142
465243,2373,1,TRUE,TRUE,1478586993,1478628340,41347
465244,2374,1,FALSE,FALSE,1436237230,1483231851,46994621
465248,2379,16,TRUE,TRUE,1454001794,1454357279,355485
465264,2380,5,FALSE,FALSE,1454438224,1466987458,12549234
465269,2381,6,FALSE,FALSE,1425564590,1477514015,51949425
465275,2382,6,FALSE,FALSE,1425564590,1477514015,51949425
465284,2387,313,TRUE,TRUE,1454218506,1454282529,64023
465597,2388,341,TRUE,TRUE,1482151242,1482155155,3913
465942,2393,2,FALSE,FALSE,1458663045,1468394422,9731377
465945,2395,2,TRUE,TRUE,1462293390,1462672897,379507
465947,2396,798,TRUE,TRUE,1462236663,1462554496,317833
466745,2397,3,TRUE,TRUE,1460678002,1460723205,45203
466750,2400,403,TRUE,TRUE,1466011484,1466014800,3316
467156,2405,7,FALSE,FALSE,1455566760,1459834816,4268056
467163,2406,7,FALSE,FALSE,1455566760,1459834816,4268056
467186,2428,17,TRUE,TRUE,1462249061,1462255792,6731
467203,2429,11,TRUE,TRUE,1482539706,1482620406,80700
467219,2435,13,TRUE,FALSE,1470647503,1471615021,967518
467233,2437,1,FALSE,FALSE,1452070864,1473009946,20939082
467243,2449,86,TRUE,TRUE,1459249345,1459356673,107328
467342,2466,4,TRUE,TRUE,1471241599,1471314483,72884
467346,2467,169,TRUE,TRUE,1456398162,1456425598,27436
467527,2484,1,TRUE,FALSE,1472547528,1474291447,1743919
467533,2490,4,TRUE,FALSE,1460859103,1462986610,2127507
467542,2497,2,TRUE,FALSE,1457313453,1458062628,749175
467553,2507,37,TRUE,FALSE,1474903964,1477415667,2511703
467600,2518,19,TRUE,TRUE,1468957847,1469205251,247404
467619,2519,34,TRUE,TRUE,1468010057,1468016951,6894
467656,2524,1,TRUE,TRUE,1456892922,1456893113,191
467671,2542,35,TRUE,TRUE,1451420079,1451833375,413296
467707,2544,333,TRUE,TRUE,1481090685,1481149378,58693
468040,2545,1,FALSE,FALSE,1470202209,1479849584,9647375
468041,2547,1,FALSE,FALSE,1426581864,1454414784,27832920
468057,2566,11,TRUE,TRUE,1466681742,1466712219,30477
468068,2567,2,TRUE,TRUE,1451450716,1451956068,505352
468083,2584,1,FALSE,FALSE,1440855406,1458311248,17455842
468084,2585,47,TRUE,TRUE,1454585546,1454602198,16652
468134,2590,36,TRUE,TRUE,1454550690,1454764988,214298
468178,2599,10,FALSE,FALSE,1463957558,1469031268,5073710
468190,2603,44,FALSE,FALSE,1452464852,1470661679,18196827
468241,2612,57,TRUE,TRUE,1476496568,1477092519,595951
468298,2613,10,TRUE,FALSE,1473366215,1474686583,1320368
468308,2614,70,TRUE,TRUE,1478896469,1479000489,104020
468382,2619,1,TRUE,TRUE,1460770949,1461293174,522225
468392,2630,2,TRUE,TRUE,1481463928,1481739541,275613
468404,2645,3,TRUE,TRUE,1472024543,1472607871,583328
468408,2647,3,FALSE,FALSE,1447384368,1456330611,8946243
468422,2660,1,TRUE,FALSE,1470686019,1471536453,850434
468437,2676,6,TRUE,TRUE,1450762478,1450797685,35207
468445,2680,27164,TRUE,TRUE,1459629971,1459654609,24638
495612,2685,102,TRUE,TRUE,1479715352,1480174958,459606
495718,2692,24,FALSE,FALSE,1470969433,1473906923,2937490
495743,2694,3,TRUE,TRUE,1466590613,1466591111,498
495755,2704,7,FALSE,FALSE,1443044876,1449365279,6320403
495762,2705,1,TRUE,TRUE,1470492440,1470508916,16476
495767,2711,3,FALSE,FALSE,1429122462,1456853014,27730552
495770,2712,1,FALSE,FALSE,1421098886,1473532652,52433766
495776,2720,2,TRUE,TRUE,1452785153,1452785850,697
495781,2724,6,TRUE,TRUE,1457810012,1458410942,600930
495793,2731,10,FALSE,FALSE,1464027569,1479407904,15380335
495803,2732,15,TRUE,FALSE,1466687752,1467937531,1249779
495820,2736,762,TRUE,TRUE,1460472388,1460473116,728
496594,2749,54,TRUE,TRUE,1463276606,1463285847,9241
496654,2756,3,TRUE,TRUE,1460473587,1460499326,25739
496660,2760,10,TRUE,TRUE,1449773863,1450224166,450303
496670,2761,1,TRUE,TRUE,1460648077,1460665086,17009
496678,2770,10,TRUE,FALSE,1452001361,1453913472,1912111
496693,2778,5,FALSE,FALSE,1470371569,1473646728,3275159
496698,2779,10,TRUE,TRUE,1467400358,1467693126,292768
496711,2783,1,TRUE,TRUE,1476128151,1476130134,1983
496720,2795,11,TRUE,TRUE,1452763349,1452764350,1001
496735,2800,1,FALSE,FALSE,1423959157,1464587460,40628303
496737,2803,919,TRUE,TRUE,1464919997,1464972944,52947
497659,2808,17,TRUE,TRUE,1462887256,1462911520,24264
497679,2818,471,TRUE,TRUE,1450380078,1450550103,170025
498155,2825,2,FALSE,FALSE,1474904954,1479703015,4798061
498157,2826,1,TRUE,TRUE,1455754891,1455756651,1760
498159,2829,54,TRUE,TRUE,1465200132,1465316735,116603
498218,2836,11,FALSE,FALSE,1460437818,1464115061,3677243
498232,2840,1,FALSE,FALSE,1422189299,1453360274,31170975
498235,2843,7,TRUE,TRUE,1454136963,1454193059,56096
498249,2852,12,FALSE,FALSE,1446906494,1467655837,20749343
498261,2853,1,TRUE,TRUE,1452147832,1452221866,74034
498272,2864,19,TRUE,TRUE,1468957847,1469207927,250080
498292,2866,4,TRUE,FALSE,1453225253,1455219395,1994142
498303,2877,1,FALSE,FALSE,1434929414,1451678306,16748892
498304,2878,166,TRUE,TRUE,1469380132,1469399659,19527
498470,2880,1,FALSE,FALSE,1472917599,1481251585,8333986
498472,2882,3,FALSE,FALSE,1434906465,1475767013,40860548
498476,2884,5,TRUE,TRUE,1455196133,1455196356,223
498481,2885,1,TRUE,TRUE,1454986637,1454987803,1166
498483,2887,2,TRUE,TRUE,1464275541,1464347974,72433
498492,2897,2,FALSE,FALSE,1456927960,1459946687,3018727
498501,2906,15,FALSE,FALSE,1455133691,1477627736,22494045
498516,2907,126,TRUE,TRUE,1464087805,1464154827,67022
498646,2912,1,TRUE,FALSE,1451271314,1452612678,1341364
498647,2913,12,FALSE,FALSE,1448318716,1452816816,4498100
498659,2914,21,TRUE,TRUE,1453141288,1453148246,6958
498681,2917,6,TRUE,TRUE,1451939939,1452523046,583107
498687,2918,7,TRUE,TRUE,1452479139,1452742911,263772
498694,2920,6,TRUE,FALSE,1451939939,1454302959,2363020
498700,2921,3,TRUE,FALSE,1455289585,1456326316,1036731
498704,2923,1,TRUE,TRUE,1452044489,1452353264,308775
498705,2924,2,TRUE,FALSE,1452061088,1452736164,675076
498707,2925,2,TRUE,TRUE,1452168880,1452281759,112879
498709,2926,5,FALSE,FALSE,1446684559,1454596828,7912269
498714,2927,7,FALSE,FALSE,1455635781,1461869197,6233416
498721,2929,12,FALSE,FALSE,1445198167,1456118860,10920693
498733,2930,32,TRUE,FALSE,1452008543,1452770440,761897
498767,2935,756,TRUE,TRUE,1464320878,1464345336,24458
499526,2939,1,TRUE,TRUE,1451965428,1452528191,562763
499527,2940,1,TRUE,TRUE,1476890428,1476991397,100969
499529,2942,1,FALSE,FALSE,1459998064,1472147214,12149150
499531,2944,396,TRUE,TRUE,1477082685,1477126287,43602
499937,2955,5,FALSE,FALSE,1470371569,1473646998,3275429
499942,2956,10,TRUE,TRUE,1467138704,1467138784,80
499956,2962,1,TRUE,FALSE,1471103037,1473571885,2468848
499957,2963,54,FALSE,FALSE,1474653191,1480893124,6239933
500012,2965,24,TRUE,TRUE,1480811387,1480820182,8795
500036,2966,13,TRUE,TRUE,1451981799,1451982334,535
500052,2971,81,TRUE,TRUE,1482240867,1482253766,12899
500134,2973,63,TRUE,TRUE,1456484613,1456703428,218815
500202,2979,1,FALSE,FALSE,1437775519,1466601606,28826087
500207,2985,4,FALSE,FALSE,1454724708,1457527743,2803035
500214,2989,62,TRUE,TRUE,1459961529,1459991747,30218
500279,2993,5,TRUE,TRUE,1450469614,1450680479,210865
500290,3003,3,TRUE,TRUE,1464552769,1464695938,143169
500297,3010,4,FALSE,FALSE,1459077005,1468679468,9602463
500305,3018,5,TRUE,TRUE,1472574234,1472574476,242
500310,3019,17,FALSE,FALSE,1455085491,1462200094,7114603
500335,3030,1,FALSE,FALSE,1451741711,1460514555,8772844
500337,3032,1743,TRUE,TRUE,1482256709,1482264284,7575
502083,3039,12,TRUE,FALSE,1477271542,1479319182,2047640
502101,3046,52,TRUE,TRUE,1463717865,1464205147,487282
502155,3049,90,TRUE,TRUE,1473676618,1473719563,42945
502245,3050,8,TRUE,TRUE,1460147656,1460407869,260213
502261,3059,203,TRUE,TRUE,1473401098,1473446875,45777
502464,3060,5,FALSE,FALSE,1423534172,1451147961,27613789
502473,3065,5,TRUE,TRUE,1476751879,1476907659,155780
502481,3069,2,FALSE,FALSE,1424190187,1472775074,48584887
502491,3079,15,FALSE,FALSE,1450143334,1454624597,4481263
502506,3080,3,TRUE,TRUE,1450854950,1450873836,18886
502515,3088,2,FALSE,FALSE,1446399885,1451326281,4926396
502518,3090,1,FALSE,FALSE,1454467471,1459618873,5151402
502528,3101,3,TRUE,FALSE,1474474681,1476755533,2280852
502534,3107,711,TRUE,TRUE,1451749594,1451955544,205950
503249,3112,2,FALSE,FALSE,1473014024,1481314797,8300773
503253,3116,103,TRUE,TRUE,1471991227,1472021415,30188
503371,3133,1,FALSE,FALSE,1429212191,1468819753,39607562
503376,3140,35,TRUE,TRUE,1467604995,1467833089,228094
503418,3151,4,TRUE,TRUE,1464287072,1464732091,445019
503423,3155,13897,TRUE,TRUE,1482346528,1482347205,677
517321,3157,230,TRUE,TRUE,1449934424,1450028162,93738
517555,3163,3,FALSE,FALSE,1458739981,1462460018,3720037
517558,3164,1377,TRUE,TRUE,1452356310,1452379517,23207
518936,3166,29,FALSE,FALSE,1442724866,1452008293,9283427
518965,3167,977,TRUE,TRUE,1482941442,1482941668,226
519946,3174,3,FALSE,FALSE,1440443480,1482621076,42177596
519949,3176,3,TRUE,TRUE,1473092263,1473111359,19096
519953,3178,56,TRUE,TRUE,1455620641,1455737125,116484
520010,3181,720,TRUE,TRUE,1469048235,1469109463,61228
520738,3192,2,FALSE,FALSE,1430739397,1453073370,22333973
520743,3196,18,FALSE,FALSE,1474603247,1477410690,2807443
520771,3207,3,FALSE,FALSE,1466010899,1475942578,9931679
520775,3209,1,FALSE,FALSE,1426581864,1454499740,27917876
520776,3210,2,TRUE,TRUE,1451873830,1451940650,66820
520779,3212,51,TRUE,TRUE,1468896319,1469419982,523663
520831,3216,1,FALSE,FALSE,1449130237,1457795203,8664966
520833,3218,1,TRUE,TRUE,1459824612,1459824830,218
520840,3225,54,TRUE,TRUE,1474058057,1474346037,287980
520904,3239,138,TRUE,TRUE,1454794467,1454796899,2432
521059,3258,1,FALSE,FALSE,1462270923,1465210902,2939979
521071,3272,4,TRUE,TRUE,1473787473,1473858744,71271
521076,3274,1,TRUE,TRUE,1457803553,1457887398,83845
521083,3281,18,TRUE,FALSE,1469795234,1471958436,2163202
521113,3296,7,FALSE,FALSE,1477833998,1483071687,5237689
521122,3299,2,TRUE,FALSE,1450217105,1452371551,2154446
521128,3305,11,TRUE,TRUE,1476989537,1477007176,17639
521143,3310,1,TRUE,TRUE,1454639420,1455045027,405607
521146,3313,1,FALSE,FALSE,1454026651,1472027804,18001153
521148,3315,665,TRUE,TRUE,1458679205,1458681159,1954
521814,3317,5,TRUE,TRUE,1450554706,1450936929,382223
521819,3318,1,TRUE,FALSE,1477942679,1479088270,1145591
521822,3321,1,FALSE,FALSE,1447869489,1454535353,6665864
521829,3328,1,TRUE,TRUE,1477962770,1478047795,85025
521839,3338,431,TRUE,TRUE,1476389213,1476825387,436174
522270,3339,1,FALSE,FALSE,1462208190,1475080301,12872111
522274,3344,21,TRUE,FALSE,1469278061,1471678342,2400281
522296,3346,1,TRUE,TRUE,1459181761,1459181946,185
522300,3350,5,TRUE,TRUE,1473431130,1473431271,141
522309,3356,6,TRUE,TRUE,1473706899,1473727870,20971
522315,3357,49,TRUE,TRUE,1482557007,1482557251,244
522366,3360,3,FALSE,FALSE,1468871771,1473010747,4138976
522369,3361,2,TRUE,TRUE,1469290504,1469611875,321371
522376,3367,11,TRUE,TRUE,1453990348,1454521273,530925
0,1460913020,0,FALSE,FALSE,1460913020,1460913020,0
1,1473543486,0,FALSE,FALSE,1473543486,1473543486,0
2,1478549994,0,FALSE,FALSE,1478549994,1478549994,0
3,1478538269,0,FALSE,FALSE,1478538269,1478538269,0
26,1459359586,0,FALSE,FALSE,1459359586,1459359586,0
27,1476523181,0,FALSE,FALSE,1476523181,1476523181,0
28,1479296510,0,FALSE,FALSE,1479296510,1479296510,0
29,1475119363,0,FALSE,FALSE,1475119363,1475119363,0
30,1475103390,0,FALSE,FALSE,1475103390,1475103390,0
33,1452029958,0,FALSE,FALSE,1452029958,1452029958,0
746,1457976364,0,FALSE,FALSE,1457976364,1457976364,0
747,1470849341,0,FALSE,FALSE,1470849341,1470849341,0
749,1474750027,0,FALSE,FALSE,1474750027,1474750027,0
750,1474578847,0,FALSE,FALSE,1474578847,1474578847,0
878,1461794140,0,FALSE,FALSE,1461794140,1461794140,0
879,1,0,FALSE,FALSE,1480448365,1480448365,0
880,2,0,FALSE,FALSE,1464138969,1464138969,0
881,3,0,FALSE,FALSE,1475937199,1475937199,0
882,5,0,FALSE,FALSE,1476034253,1476034253,0
883,6,0,FALSE,FALSE,1475600789,1475600789,0
884,7,0,FALSE,FALSE,1477094910,1477094910,0
885,8,0,FALSE,FALSE,1456785783,1456785783,0
886,9,0,FALSE,FALSE,1452521258,1452521258,0
894,11,0,FALSE,FALSE,1476235474,1476235474,0
895,12,0,FALSE,FALSE,1474298064,1474298064,0
896,13,0,FALSE,FALSE,1474298649,1474298649,0
897,14,0,FALSE,FALSE,1479853719,1479853719,0
898,15,0,FALSE,FALSE,1452867133,1452867133,0
1626,18,0,FALSE,FALSE,1473868867,1473868867,0
1627,19,0,FALSE,FALSE,1474143156,1474143156,0
1628,20,0,FALSE,FALSE,1475456908,1475456908,0
1630,22,0,FALSE,FALSE,1478603688,1478603688,0
1631,23,0,FALSE,FALSE,1473575346,1473575346,0
35434,25,0,FALSE,FALSE,1475812572,1475812572,0
35435,26,0,FALSE,FALSE,1481378604,1481378604,0
35436,29,0,FALSE,FALSE,1480467515,1480467515,0
35437,30,0,FALSE,FALSE,1461707961,1461707961,0
35443,32,0,FALSE,FALSE,1474768733,1474768733,0
35444,34,0,FALSE,FALSE,1473946052,1473946052,0
35446,36,0,FALSE,FALSE,1457717655,1457717655,0
35447,38,0,FALSE,FALSE,1468610191,1468610191,0
35448,39,0,FALSE,FALSE,1467110681,1467110681,0
35449,40,0,FALSE,FALSE,1480021020,1480021020,0
35450,41,0,FALSE,FALSE,1462663436,1462663436,0
35451,42,0,FALSE,FALSE,1481374617,1481374617,0
35454,46,0,FALSE,FALSE,1479912433,1479912433,0
35455,47,0,FALSE,FALSE,1471872805,1471872805,0
35456,48,0,FALSE,FALSE,1459719292,1459719292,0
35457,49,0,FALSE,FALSE,1467341649,1467341649,0
35458,50,0,FALSE,FALSE,1472737179,1472737179,0
35459,51,0,FALSE,FALSE,1471047401,1471047401,0
35460,52,0,FALSE,FALSE,1480439987,1480439987,0
35461,53,0,FALSE,FALSE,1477565791,1477565791,0
35462,54,0,FALSE,FALSE,1479833243,1479833243,0
35463,55,0,FALSE,FALSE,1477594848,1477594848,0
35642,58,0,FALSE,FALSE,1480203745,1480203745,0
35643,59,0,FALSE,FALSE,1457960729,1457960729,0
35644,60,0,FALSE,FALSE,1452112933,1452112933,0
35645,61,0,FALSE,FALSE,1476979019,1476979019,0
38639,63,0,FALSE,FALSE,1476301617,1476301617,0
40300,69,0,FALSE,FALSE,1471662365,1471662365,0
41012,71,0,FALSE,FALSE,1478871167,1478871167,0
41013,72,0,FALSE,FALSE,1463463184,1463463184,0
41014,74,0,FALSE,FALSE,1480529471,1480529471,0
41015,75,0,FALSE,FALSE,1473783808,1473783808,0
41016,77,0,FALSE,FALSE,1479754539,1479754539,0
41017,78,0,FALSE,FALSE,1457042896,1457042896,0
41028,80,0,FALSE,FALSE,1480223883,1480223883,0
41029,82,0,FALSE,FALSE,1480244267,1480244267,0
41030,83,0,FALSE,FALSE,1450989728,1450989728,0
41031,84,0,FALSE,FALSE,1476388555,1476388555,0
41032,85,0,FALSE,FALSE,1468426649,1468426649,0
41033,86,0,FALSE,FALSE,1477586754,1477586754,0
41034,87,0,FALSE,FALSE,1479895386,1479895386,0
41042,89,0,FALSE,FALSE,1475677906,1475677906,0
41043,90,0,FALSE,FALSE,1480125631,1480125631,0
41044,91,0,FALSE,FALSE,1475131341,1475131341,0
41045,93,0,FALSE,FALSE,1472602957,1472602957,0
41056,95,0,FALSE,FALSE,1479816193,1479816193,0
41059,97,0,FALSE,FALSE,1473432492,1473432492,0
41060,98,0,FALSE,FALSE,1457044594,1457044594,0
41061,101,0,FALSE,FALSE,1479482166,1479482166,0
41062,102,0,FALSE,FALSE,1466347377,1466347377,0
41063,103,0,FALSE,FALSE,1472465248,1472465248,0
41064,104,0,FALSE,FALSE,1472617052,1472617052,0
41082,106,0,FALSE,FALSE,1478779275,1478779275,0
41109,110,0,FALSE,FALSE,1470879400,1470879400,0
41110,111,0,FALSE,FALSE,1476136596,1476136596,0
42519,114,0,FALSE,FALSE,1480513327,1480513327,0
42567,118,0,FALSE,FALSE,1461782613,1461782613,0
42641,120,0,FALSE,FALSE,1468506820,1468506820,0
42642,121,0,FALSE,FALSE,1456940377,1456940377,0
42643,122,0,FALSE,FALSE,1476978901,1476978901,0
42644,123,0,FALSE,FALSE,1471549603,1471549603,0
42646,125,0,FALSE,FALSE,1456371713,1456371713,0
42648,130,0,FALSE,FALSE,1476923562,1476923562,0
42649,131,0,FALSE,FALSE,1472414234,1472414234,0
42650,132,0,FALSE,FALSE,1474748965,1474748965,0
42651,133,0,FALSE,FALSE,1474635177,1474635177,0
42652,134,0,FALSE,FALSE,1478709875,1478709875,0
42653,135,0,FALSE,FALSE,1464879670,1464879670,0
42654,136,0,FALSE,FALSE,1472249505,1472249505,0
42655,137,0,FALSE,FALSE,1475700664,1475700664,0
42656,138,0,FALSE,FALSE,1474540926,1474540926,0
43415,140,0,FALSE,FALSE,1479911461,1479911461,0
43416,141,0,FALSE,FALSE,1460893215,1460893215,0
43417,142,0,FALSE,FALSE,1471691892,1471691892,0
43418,143,0,FALSE,FALSE,1480010928,1480010928,0
43419,144,0,FALSE,FALSE,1478955688,1478955688,0
43420,145,0,FALSE,FALSE,1455669814,1455669814,0
43433,147,0,FALSE,FALSE,1466621157,1466621157,0
44009,151,0,FALSE,FALSE,1478102611,1478102611,0
44013,155,0,FALSE,FALSE,1453386668,1453386668,0
44014,158,0,FALSE,FALSE,1479922051,1479922051,0
44015,159,0,FALSE,FALSE,1476166383,1476166383,0
44028,165,0,FALSE,FALSE,1469931800,1469931800,0
44029,166,0,FALSE,FALSE,1480349450,1480349450,0
44030,167,0,FALSE,FALSE,1478616705,1478616705,0
44481,170,0,FALSE,FALSE,1457039684,1457039684,0
44482,171,0,FALSE,FALSE,1477945680,1477945680,0
44483,172,0,FALSE,FALSE,1480385477,1480385477,0
44486,174,0,FALSE,FALSE,1453177831,1453177831,0
44487,175,0,FALSE,FALSE,1479661847,1479661847,0
44488,176,0,FALSE,FALSE,1454521197,1454521197,0
44489,177,0,FALSE,FALSE,1476823793,1476823793,0
44490,178,0,FALSE,FALSE,1480393079,1480393079,0
44491,179,0,FALSE,FALSE,1478277476,1478277476,0
44492,181,0,FALSE,FALSE,1478107362,1478107362,0
45095,183,0,FALSE,FALSE,1472606938,1472606938,0
45096,184,0,FALSE,FALSE,1470281304,1470281304,0
47811,188,0,FALSE,FALSE,1472203637,1472203637,0
47812,189,0,FALSE,FALSE,1477886534,1477886534,0
47813,190,0,FALSE,FALSE,1479741465,1479741465,0
47814,191,0,FALSE,FALSE,1480293872,1480293872,0
47815,192,0,FALSE,FALSE,1479940151,1479940151,0
47817,194,0,FALSE,FALSE,1462639233,1462639233,0
47826,196,0,FALSE,FALSE,1479397805,1479397805,0
47827,198,0,FALSE,FALSE,1470668947,1470668947,0
47828,199,0,FALSE,FALSE,1475931721,1475931721,0
47829,201,0,FALSE,FALSE,1466402980,1466402980,0
47830,202,0,FALSE,FALSE,1453901735,1453901735,0
47831,203,0,FALSE,FALSE,1450038090,1450038090,0
47832,204,0,FALSE,FALSE,1452859784,1452859784,0
47833,205,0,FALSE,FALSE,1475878141,1475878141,0
47834,207,0,FALSE,FALSE,1472396593,1472396593,0
47835,209,0,FALSE,FALSE,1477801854,1477801854,0
47837,211,0,FALSE,FALSE,1478199047,1478199047,0
47838,212,0,FALSE,FALSE,1457704941,1457704941,0
47839,214,0,FALSE,FALSE,1474290475,1474290475,0
47853,217,0,FALSE,FALSE,1476900999,1476900999,0
47854,219,0,FALSE,FALSE,1478184777,1478184777,0
47855,220,0,FALSE,FALSE,1477822418,1477822418,0
47856,221,0,FALSE,FALSE,1472810048,1472810048,0
47857,222,0,FALSE,FALSE,1455928678,1455928678,0
47858,223,0,FALSE,FALSE,1476963357,1476963357,0
47861,225,0,FALSE,FALSE,1474310174,1474310174,0
47862,226,0,FALSE,FALSE,1474001471,1474001471,0
47863,227,0,FALSE,FALSE,1475549072,1475549072,0
47893,229,0,FALSE,FALSE,1477655709,1477655709,0
47894,230,0,FALSE,FALSE,1474224488,1474224488,0
47897,232,0,FALSE,FALSE,1466464401,1466464401,0
47898,233,0,FALSE,FALSE,1477555592,1477555592,0
47899,234,0,FALSE,FALSE,1473967774,1473967774,0
48311,236,0,FALSE,FALSE,1453736559,1453736559,0
48312,238,0,FALSE,FALSE,1478458177,1478458177,0
48327,240,0,FALSE,FALSE,1479769292,1479769292,0
48365,243,0,FALSE,FALSE,1480064067,1480064067,0
48366,244,0,FALSE,FALSE,1475700087,1475700087,0
48367,246,0,FALSE,FALSE,1474630966,1474630966,0
48368,247,0,FALSE,FALSE,1467867768,1467867768,0
48369,249,0,FALSE,FALSE,1479915714,1479915714,0
48374,252,0,FALSE,FALSE,1476277764,1476277764,0
48375,253,0,FALSE,FALSE,1473592113,1473592113,0
51095,257,0,FALSE,FALSE,1468541625,1468541625,0
51096,258,0,FALSE,FALSE,1480029368,1480029368,0
51098,261,0,FALSE,FALSE,1455370903,1455370903,0
51099,262,0,FALSE,FALSE,1479764391,1479764391,0
51100,263,0,FALSE,FALSE,1453684149,1453684149,0
51109,265,0,FALSE,FALSE,1480150769,1480150769,0
51111,267,0,FALSE,FALSE,1478522231,1478522231,0
51112,268,0,FALSE,FALSE,1466013301,1466013301,0
51113,270,0,FALSE,FALSE,1472833111,1472833111,0
51114,271,0,FALSE,FALSE,1471210702,1471210702,0
51115,272,0,FALSE,FALSE,1471028604,1471028604,0
51116,273,0,FALSE,FALSE,1469928138,1469928138,0
51117,274,0,FALSE,FALSE,1456744242,1456744242,0
51118,275,0,FALSE,FALSE,1480280208,1480280208,0
51799,277,0,FALSE,FALSE,1476812371,1476812371,0
51800,278,0,FALSE,FALSE,1456513244,1456513244,0
51801,279,0,FALSE,FALSE,1479759586,1479759586,0
51802,280,0,FALSE,FALSE,1466569686,1466569686,0
51803,281,0,FALSE,FALSE,1450127070,1450127070,0
51804,282,0,FALSE,FALSE,1475907165,1475907165,0
51805,283,0,FALSE,FALSE,1479409062,1479409062,0
51806,284,0,FALSE,FALSE,1473942216,1473942216,0
51857,290,0,FALSE,FALSE,1460210101,1460210101,0
51863,293,0,FALSE,FALSE,1468543443,1468543443,0
51869,297,0,FALSE,FALSE,1473226532,1473226532,0
51870,298,0,FALSE,FALSE,1475621728,1475621728,0
51871,300,0,FALSE,FALSE,1480895868,1480895868,0
52561,302,0,FALSE,FALSE,1477077593,1477077593,0
52562,303,0,FALSE,FALSE,1477012247,1477012247,0
52563,304,0,FALSE,FALSE,1479180625,1479180625,0
52564,305,0,FALSE,FALSE,1459789799,1459789799,0
52565,306,0,FALSE,FALSE,1480173461,1480173461,0
52566,307,0,FALSE,FALSE,1475820876,1475820876,0
52567,308,0,FALSE,FALSE,1475820876,1475820876,0
52569,310,0,FALSE,FALSE,1475415029,1475415029,0
52570,311,0,FALSE,FALSE,1459581275,1459581275,0
52571,312,0,FALSE,FALSE,1479144903,1479144903,0
52572,313,0,FALSE,FALSE,1475169298,1475169298,0
52584,316,0,FALSE,FALSE,1461196422,1461196422,0
52585,317,0,FALSE,FALSE,1464613982,1464613982,0
52586,318,0,FALSE,FALSE,1470817253,1470817253,0
52587,319,0,FALSE,FALSE,1470817253,1470817253,0
52588,320,0,FALSE,FALSE,1453318572,1453318572,0
52589,321,0,FALSE,FALSE,1482023680,1482023680,0
52590,323,0,FALSE,FALSE,1480378894,1480378894,0
52591,324,0,FALSE,FALSE,1480453967,1480453967,0
52592,325,0,FALSE,FALSE,1474589422,1474589422,0
52598,327,0,FALSE,FALSE,1471801504,1471801504,0
52599,328,0,FALSE,FALSE,1454201657,1454201657,0
52600,329,0,FALSE,FALSE,1468503436,1468503436,0
52604,331,0,FALSE,FALSE,1478163502,1478163502,0
52605,332,0,FALSE,FALSE,1452801063,1452801063,0
52606,333,0,FALSE,FALSE,1464207608,1464207608,0
52609,337,0,FALSE,FALSE,1469069883,1469069883,0
52610,338,0,FALSE,FALSE,1476145395,1476145395,0
52611,340,0,FALSE,FALSE,1475008828,1475008828,0
52612,341,0,FALSE,FALSE,1480519444,1480519444,0
52613,343,0,FALSE,FALSE,1461620937,1461620937,0
52614,344,0,FALSE,FALSE,1467899585,1467899585,0
52615,345,0,FALSE,FALSE,1482016753,1482016753,0
55674,347,0,FALSE,FALSE,1470437735,1470437735,0
55675,349,0,FALSE,FALSE,1476620591,1476620591,0
55676,350,0,FALSE,FALSE,1476133998,1476133998,0
55677,351,0,FALSE,FALSE,1478869361,1478869361,0
55678,352,0,FALSE,FALSE,1467086043,1467086043,0
55679,353,0,FALSE,FALSE,1467668767,1467668767,0
55680,355,0,FALSE,FALSE,1468357717,1468357717,0
55681,356,0,FALSE,FALSE,1477153117,1477153117,0
55684,358,0,FALSE,FALSE,1450052916,1450052916,0
55685,359,0,FALSE,FALSE,1452686758,1452686758,0
55686,360,0,FALSE,FALSE,1481407682,1481407682,0
55687,362,0,FALSE,FALSE,1470187904,1470187904,0
55688,364,0,FALSE,FALSE,1456323701,1456323701,0
55689,369,0,FALSE,FALSE,1449003525,1449003525,0
55690,370,0,FALSE,FALSE,1481741524,1481741524,0
55691,371,0,FALSE,FALSE,1477017465,1477017465,0
55692,372,0,FALSE,FALSE,1481142077,1481142077,0
55693,374,0,FALSE,FALSE,1464626797,1464626797,0
55733,379,0,FALSE,FALSE,1478490820,1478490820,0
55745,381,0,FALSE,FALSE,1450499494,1450499494,0
55746,382,0,FALSE,FALSE,1478008680,1478008680,0
55747,383,0,FALSE,FALSE,1472597914,1472597914,0
55748,384,0,FALSE,FALSE,1478416916,1478416916,0
55749,385,0,FALSE,FALSE,1483093271,1483093271,0
55750,386,0,FALSE,FALSE,1467019042,1467019042,0
55751,387,0,FALSE,FALSE,1473071288,1473071288,0
55752,388,0,FALSE,FALSE,1452480304,1452480304,0
55753,389,0,FALSE,FALSE,1477757101,1477757101,0
55754,390,0,FALSE,FALSE,1461859325,1461859325,0
55755,391,0,FALSE,FALSE,1464777744,1464777744,0
55756,392,0,FALSE,FALSE,1472478771,1472478771,0
55757,393,0,FALSE,FALSE,1452713457,1452713457,0
55758,394,0,FALSE,FALSE,1455298112,1455298112,0
55759,396,0,FALSE,FALSE,1479796934,1479796934,0
55760,397,0,FALSE,FALSE,1474293121,1474293121,0
55761,398,0,FALSE,FALSE,1480354273,1480354273,0
55762,399,0,FALSE,FALSE,1471359105,1471359105,0
55763,401,0,FALSE,FALSE,1464036365,1464036365,0
55764,404,0,FALSE,FALSE,1462423886,1462423886,0
55765,405,0,FALSE,FALSE,1454980509,1454980509,0
55766,407,0,FALSE,FALSE,1452030751,1452030751,0
55768,409,0,FALSE,FALSE,1465257352,1465257352,0
55769,410,0,FALSE,FALSE,1481429363,1481429363,0
55770,411,0,FALSE,FALSE,1469313289,1469313289,0
55771,413,0,FALSE,FALSE,1468809773,1468809773,0
55772,414,0,FALSE,FALSE,1466416898,1466416898,0
55773,417,0,FALSE,FALSE,1450319708,1450319708,0
55774,418,0,FALSE,FALSE,1474631645,1474631645,0
55775,419,0,FALSE,FALSE,1472207283,1472207283,0
55776,420,0,FALSE,FALSE,1449505341,1449505341,0
55777,421,0,FALSE,FALSE,1462241413,1462241413,0
55779,423,0,FALSE,FALSE,1449689892,1449689892,0
55780,424,0,FALSE,FALSE,1451775344,1451775344,0
55781,425,0,FALSE,FALSE,1477593221,1477593221,0
55782,426,0,FALSE,FALSE,1477593221,1477593221,0
55808,429,0,FALSE,FALSE,1449921950,1449921950,0
55810,431,0,FALSE,FALSE,1466477138,1466477138,0
55811,432,0,FALSE,FALSE,1476226430,1476226430,0
55812,435,0,FALSE,FALSE,1454632689,1454632689,0
55813,436,0,FALSE,FALSE,1456012652,1456012652,0
85226,438,0,FALSE,FALSE,1481130887,1481130887,0
85227,439,0,FALSE,FALSE,1460970260,1460970260,0
85228,440,0,FALSE,FALSE,1465770905,1465770905,0
85229,441,0,FALSE,FALSE,1463498797,1463498797,0
85230,443,0,FALSE,FALSE,1451758594,1451758594,0
85231,444,0,FALSE,FALSE,1458151785,1458151785,0
85232,445,0,FALSE,FALSE,1479338680,1479338680,0
85238,448,0,FALSE,FALSE,1466132441,1466132441,0
85239,449,0,FALSE,FALSE,1456257571,1456257571,0
85240,450,0,FALSE,FALSE,1478246747,1478246747,0
85241,451,0,FALSE,FALSE,1464718558,1464718558,0
85242,452,0,FALSE,FALSE,1472485343,1472485343,0
141290,454,0,FALSE,FALSE,1456570580,1456570580,0
141291,455,0,FALSE,FALSE,1458152873,1458152873,0
141469,457,0,FALSE,FALSE,1462986393,1462986393,0
141470,458,0,FALSE,FALSE,1469029239,1469029239,0
141471,459,0,FALSE,FALSE,1454010632,1454010632,0
141472,460,0,FALSE,FALSE,1476829226,1476829226,0
141473,463,0,FALSE,FALSE,1474310700,1474310700,0
141475,467,0,FALSE,FALSE,1470003609,1470003609,0
141476,468,0,FALSE,FALSE,1474301373,1474301373,0
141477,469,0,FALSE,FALSE,1462383464,1462383464,0
141478,470,0,FALSE,FALSE,1460565960,1460565960,0
141479,471,0,FALSE,FALSE,1475000142,1475000142,0
141480,472,0,FALSE,FALSE,1462830281,1462830281,0
141481,473,0,FALSE,FALSE,1470325959,1470325959,0
141482,474,0,FALSE,FALSE,1477526732,1477526732,0
141483,475,0,FALSE,FALSE,1456845768,1456845768,0
141484,476,0,FALSE,FALSE,1474731999,1474731999,0
141485,477,0,FALSE,FALSE,1466434403,1466434403,0
141486,478,0,FALSE,FALSE,1474744805,1474744805,0
141487,479,0,FALSE,FALSE,1450981303,1450981303,0
141488,480,0,FALSE,FALSE,1470295643,1470295643,0
141489,481,0,FALSE,FALSE,1470295643,1470295643,0
141490,483,0,FALSE,FALSE,1481193295,1481193295,0
141491,484,0,FALSE,FALSE,1460655657,1460655657,0
141492,485,0,FALSE,FALSE,1468822594,1468822594,0
141493,486,0,FALSE,FALSE,1462565343,1462565343,0
141494,487,0,FALSE,FALSE,1471520552,1471520552,0
141495,488,0,FALSE,FALSE,1455397206,1455397206,0
141496,489,0,FALSE,FALSE,1480512836,1480512836,0
141497,490,0,FALSE,FALSE,1450755464,1450755464,0
141498,491,0,FALSE,FALSE,1456854316,1456854316,0
141499,492,0,FALSE,FALSE,1451347190,1451347190,0
141500,493,0,FALSE,FALSE,1462885392,1462885392,0
141501,495,0,FALSE,FALSE,1474714495,1474714495,0
141506,497,0,FALSE,FALSE,1469053080,1469053080,0
141508,499,0,FALSE,FALSE,1462127719,1462127719,0
141511,503,0,FALSE,FALSE,1478375561,1478375561,0
141513,505,0,FALSE,FALSE,1453469719,1453469719,0
141514,506,0,FALSE,FALSE,1462798043,1462798043,0
141515,507,0,FALSE,FALSE,1454888923,1454888923,0
141516,508,0,FALSE,FALSE,1458138800,1458138800,0
141517,509,0,FALSE,FALSE,1464595607,1464595607,0
141518,510,0,FALSE,FALSE,1451368454,1451368454,0
141519,511,0,FALSE,FALSE,1449512205,1449512205,0
141520,512,0,FALSE,FALSE,1462204109,1462204109,0
141521,515,0,FALSE,FALSE,1461828141,1461828141,0
141527,517,0,FALSE,FALSE,1472013547,1472013547,0
141528,518,0,FALSE,FALSE,1472338989,1472338989,0
141529,519,0,FALSE,FALSE,1471396676,1471396676,0
141530,520,0,FALSE,FALSE,1459296168,1459296168,0
141531,522,0,FALSE,FALSE,1467784503,1467784503,0
141532,523,0,FALSE,FALSE,1449150719,1449150719,0
141553,525,0,FALSE,FALSE,1452050710,1452050710,0
141554,526,0,FALSE,FALSE,1462038147,1462038147,0
141555,528,0,FALSE,FALSE,1479397503,1479397503,0
141907,531,0,FALSE,FALSE,1474482365,1474482365,0
141908,532,0,FALSE,FALSE,1467321867,1467321867,0
141938,535,0,FALSE,FALSE,1456446728,1456446728,0
141940,537,0,FALSE,FALSE,1470379569,1470379569,0
141941,538,0,FALSE,FALSE,1480934816,1480934816,0
141942,540,0,FALSE,FALSE,1478854762,1478854762,0
141943,541,0,FALSE,FALSE,1464325578,1464325578,0
141944,542,0,FALSE,FALSE,1453769148,1453769148,0
141945,543,0,FALSE,FALSE,1456544774,1456544774,0
141946,544,0,FALSE,FALSE,1452647427,1452647427,0
141947,545,0,FALSE,FALSE,1473819749,1473819749,0
141948,546,0,FALSE,FALSE,1465233079,1465233079,0
141949,547,0,FALSE,FALSE,1469920707,1469920707,0
141950,548,0,FALSE,FALSE,1473878461,1473878461,0
141951,549,0,FALSE,FALSE,1471971310,1471971310,0
141954,551,0,FALSE,FALSE,1472600344,1472600344,0
141955,553,0,FALSE,FALSE,1455131111,1455131111,0
141956,555,0,FALSE,FALSE,1473367691,1473367691,0
141982,557,0,FALSE,FALSE,1465269688,1465269688,0
141983,558,0,FALSE,FALSE,1455044315,1455044315,0
141984,559,0,FALSE,FALSE,1479929339,1479929339,0
141985,561,0,FALSE,FALSE,1450561414,1450561414,0
141998,563,0,FALSE,FALSE,1477590157,1477590157,0
141999,566,0,FALSE,FALSE,1464632265,1464632265,0
142000,567,0,FALSE,FALSE,1466803258,1466803258,0
142001,568,0,FALSE,FALSE,1468894945,1468894945,0
142002,569,0,FALSE,FALSE,1466527248,1466527248,0
142003,570,0,FALSE,FALSE,1478830936,1478830936,0
142004,571,0,FALSE,FALSE,1478830936,1478830936,0
142005,572,0,FALSE,FALSE,1467671646,1467671646,0
142006,573,0,FALSE,FALSE,1477977618,1477977618,0
142007,574,0,FALSE,FALSE,1473713137,1473713137,0
142009,576,0,FALSE,FALSE,1463779821,1463779821,0
142010,578,0,FALSE,FALSE,1458927760,1458927760,0
142011,579,0,FALSE,FALSE,1472396566,1472396566,0
142012,580,0,FALSE,FALSE,1456518371,1456518371,0
142013,581,0,FALSE,FALSE,1467843440,1467843440,0
142014,582,0,FALSE,FALSE,1466214604,1466214604,0
142015,583,0,FALSE,FALSE,1455648701,1455648701,0
142016,584,0,FALSE,FALSE,1471092973,1471092973,0
142017,586,0,FALSE,FALSE,1478638803,1478638803,0
142018,587,0,FALSE,FALSE,1469000250,1469000250,0
142020,589,0,FALSE,FALSE,1456238106,1456238106,0
142900,591,0,FALSE,FALSE,1451159586,1451159586,0
142901,592,0,FALSE,FALSE,1470294033,1470294033,0
142902,593,0,FALSE,FALSE,1470294033,1470294033,0
142903,594,0,FALSE,FALSE,1466572637,1466572637,0
142904,595,0,FALSE,FALSE,1473697050,1473697050,0
142905,596,0,FALSE,FALSE,1482265400,1482265400,0
142906,597,0,FALSE,FALSE,1452111889,1452111889,0
142907,598,0,FALSE,FALSE,1477439795,1477439795,0
142908,599,0,FALSE,FALSE,1477136880,1477136880,0
142909,600,0,FALSE,FALSE,1479733780,1479733780,0
142913,602,0,FALSE,FALSE,1455367517,1455367517,0
142914,603,0,FALSE,FALSE,1470731446,1470731446,0
142915,604,0,FALSE,FALSE,1470731446,1470731446,0
142916,605,0,FALSE,FALSE,1470729984,1470729984,0
142917,606,0,FALSE,FALSE,1470729984,1470729984,0
142918,607,0,FALSE,FALSE,1463882951,1463882951,0
142919,608,0,FALSE,FALSE,1474451264,1474451264,0
142920,609,0,FALSE,FALSE,1449951822,1449951822,0
142921,610,0,FALSE,FALSE,1467010868,1467010868,0
142922,611,0,FALSE,FALSE,1473553562,1473553562,0
142930,613,0,FALSE,FALSE,1480810888,1480810888,0
142931,614,0,FALSE,FALSE,1477945375,1477945375,0
142932,615,0,FALSE,FALSE,1449551539,1449551539,0
142933,616,0,FALSE,FALSE,1482799641,1482799641,0
215992,618,0,FALSE,FALSE,1451952280,1451952280,0
215994,620,0,FALSE,FALSE,1453435876,1453435876,0
215995,621,0,FALSE,FALSE,1461098644,1461098644,0
215996,624,0,FALSE,FALSE,1451676280,1451676280,0
216002,626,0,FALSE,FALSE,1472564888,1472564888,0
216003,627,0,FALSE,FALSE,1473189048,1473189048,0
216004,628,0,FALSE,FALSE,1467818201,1467818201,0
216006,630,0,FALSE,FALSE,1460151614,1460151614,0
216007,631,0,FALSE,FALSE,1468123352,1468123352,0
216008,633,0,FALSE,FALSE,1456288616,1456288616,0
216009,634,0,FALSE,FALSE,1463542009,1463542009,0
216010,635,0,FALSE,FALSE,1450986011,1450986011,0
216011,636,0,FALSE,FALSE,1460651184,1460651184,0
216012,637,0,FALSE,FALSE,1449614843,1449614843,0
216013,638,0,FALSE,FALSE,1459934303,1459934303,0
216015,640,0,FALSE,FALSE,1468929381,1468929381,0
216016,641,0,FALSE,FALSE,1465918874,1465918874,0
216017,642,0,FALSE,FALSE,1475658005,1475658005,0
216018,643,0,FALSE,FALSE,1471359280,1471359280,0
216019,644,0,FALSE,FALSE,1473263162,1473263162,0
216087,646,0,FALSE,FALSE,1474301210,1474301210,0
216088,647,0,FALSE,FALSE,1474357827,1474357827,0
216089,648,0,FALSE,FALSE,1474357827,1474357827,0
216090,649,0,FALSE,FALSE,1474906808,1474906808,0
216098,651,0,FALSE,FALSE,1454949854,1454949854,0
216099,652,0,FALSE,FALSE,1474233320,1474233320,0
216100,653,0,FALSE,FALSE,1457368352,1457368352,0
216101,654,0,FALSE,FALSE,1479701350,1479701350,0
216102,655,0,FALSE,FALSE,1461812959,1461812959,0
216106,658,0,FALSE,FALSE,1469142253,1469142253,0
216107,659,0,FALSE,FALSE,1454675735,1454675735,0
216117,661,0,FALSE,FALSE,1462284103,1462284103,0
216118,662,0,FALSE,FALSE,1469734335,1469734335,0
216125,664,0,FALSE,FALSE,1463258002,1463258002,0
216126,665,0,FALSE,FALSE,1474981023,1474981023,0
216127,666,0,FALSE,FALSE,1454337481,1454337481,0
216128,667,0,FALSE,FALSE,1478975512,1478975512,0
216129,668,0,FALSE,FALSE,1468192080,1468192080,0
216130,669,0,FALSE,FALSE,1454947291,1454947291,0
216131,670,0,FALSE,FALSE,1461273806,1461273806,0
216132,671,0,FALSE,FALSE,1452551198,1452551198,0
216133,672,0,FALSE,FALSE,1468500027,1468500027,0
216134,673,0,FALSE,FALSE,1455288982,1455288982,0
216145,675,0,FALSE,FALSE,1453820231,1453820231,0
216146,676,0,FALSE,FALSE,1474157851,1474157851,0
216147,677,0,FALSE,FALSE,1474157851,1474157851,0
216155,683,0,FALSE,FALSE,1457952429,1457952429,0
216156,685,0,FALSE,FALSE,1474667066,1474667066,0
216170,688,0,FALSE,FALSE,1455135714,1455135714,0
216171,689,0,FALSE,FALSE,1468272854,1468272854,0
216172,690,0,FALSE,FALSE,1452366791,1452366791,0
216173,691,0,FALSE,FALSE,1481842135,1481842135,0
216174,692,0,FALSE,FALSE,1473453424,1473453424,0
216175,693,0,FALSE,FALSE,1477662022,1477662022,0
216176,695,0,FALSE,FALSE,1477231499,1477231499,0
216177,696,0,FALSE,FALSE,1475414078,1475414078,0
216178,697,0,FALSE,FALSE,1476529047,1476529047,0
216179,698,0,FALSE,FALSE,1475414161,1475414161,0
216180,700,0,FALSE,FALSE,1459478138,1459478138,0
216181,701,0,FALSE,FALSE,1477122086,1477122086,0
216182,702,0,FALSE,FALSE,1472108811,1472108811,0
216183,703,0,FALSE,FALSE,1461214603,1461214603,0
216184,704,0,FALSE,FALSE,1457716963,1457716963,0
216185,705,0,FALSE,FALSE,1460059384,1460059384,0
216186,707,0,FALSE,FALSE,1477344408,1477344408,0
216187,708,0,FALSE,FALSE,1460162273,1460162273,0
216188,709,0,FALSE,FALSE,1469366962,1469366962,0
216189,710,0,FALSE,FALSE,1457466435,1457466435,0
216281,712,0,FALSE,FALSE,1472961143,1472961143,0
216289,714,0,FALSE,FALSE,1458248314,1458248314,0
216290,715,0,FALSE,FALSE,1455435249,1455435249,0
216291,716,0,FALSE,FALSE,1451748898,1451748898,0
216292,717,0,FALSE,FALSE,1467841632,1467841632,0
216293,718,0,FALSE,FALSE,1454179746,1454179746,0
216294,719,0,FALSE,FALSE,1461697995,1461697995,0
216295,720,0,FALSE,FALSE,1483061731,1483061731,0
216296,721,0,FALSE,FALSE,1467130110,1467130110,0
216297,723,0,FALSE,FALSE,1482097607,1482097607,0
216298,724,0,FALSE,FALSE,1462523483,1462523483,0
216299,725,0,FALSE,FALSE,1462523483,1462523483,0
216300,727,0,FALSE,FALSE,1451390266,1451390266,0
216301,728,0,FALSE,FALSE,1477928394,1477928394,0
216302,729,0,FALSE,FALSE,1472503532,1472503532,0
216303,730,0,FALSE,FALSE,1468949603,1468949603,0
216304,731,0,FALSE,FALSE,1451878746,1451878746,0
216305,732,0,FALSE,FALSE,1474063442,1474063442,0
216306,733,0,FALSE,FALSE,1474063442,1474063442,0
216422,735,0,FALSE,FALSE,1451431874,1451431874,0
216423,736,0,FALSE,FALSE,1477875768,1477875768,0
216424,737,0,FALSE,FALSE,1458534284,1458534284,0
216425,738,0,FALSE,FALSE,1478704990,1478704990,0
216426,739,0,FALSE,FALSE,1482572972,1482572972,0
216427,740,0,FALSE,FALSE,1455645554,1455645554,0
216428,741,0,FALSE,FALSE,1471803959,1471803959,0
216448,743,0,FALSE,FALSE,1471994850,1471994850,0
216449,744,0,FALSE,FALSE,1457524833,1457524833,0
216450,745,0,FALSE,FALSE,1474124882,1474124882,0
216451,746,0,FALSE,FALSE,1467281596,1467281596,0
216454,748,0,FALSE,FALSE,1461867810,1461867810,0
216455,749,0,FALSE,FALSE,1473281816,1473281816,0
216456,750,0,FALSE,FALSE,1454437098,1454437098,0
216457,751,0,FALSE,FALSE,1457058140,1457058140,0
216462,753,0,FALSE,FALSE,1464657609,1464657609,0
216464,756,0,FALSE,FALSE,1463029689,1463029689,0
216465,758,0,FALSE,FALSE,1478114235,1478114235,0
216480,760,0,FALSE,FALSE,1480542720,1480542720,0
216481,761,0,FALSE,FALSE,1471478674,1471478674,0
216482,762,0,FALSE,FALSE,1462209230,1462209230,0
216483,763,0,FALSE,FALSE,1461980508,1461980508,0
216484,764,0,FALSE,FALSE,1451999204,1451999204,0
216485,765,0,FALSE,FALSE,1463871870,1463871870,0
216486,766,0,FALSE,FALSE,1467903457,1467903457,0
216487,767,0,FALSE,FALSE,1467784638,1467784638,0
216527,769,0,FALSE,FALSE,1462362301,1462362301,0
216528,770,0,FALSE,FALSE,1477784300,1477784300,0
216549,772,0,FALSE,FALSE,1456034226,1456034226,0
216550,773,0,FALSE,FALSE,1463748228,1463748228,0
216551,774,0,FALSE,FALSE,1459102616,1459102616,0
216552,775,0,FALSE,FALSE,1452799413,1452799413,0
216555,777,0,FALSE,FALSE,1475186672,1475186672,0
216568,780,0,FALSE,FALSE,1468248040,1468248040,0
216569,781,0,FALSE,FALSE,1470295893,1470295893,0
216570,782,0,FALSE,FALSE,1470295893,1470295893,0
216571,783,0,FALSE,FALSE,1478476494,1478476494,0
216572,784,0,FALSE,FALSE,1482878812,1482878812,0
216578,786,0,FALSE,FALSE,1453106012,1453106012,0
216587,789,0,FALSE,FALSE,1483232096,1483232096,0
216598,793,0,FALSE,FALSE,1472240383,1472240383,0
216601,795,0,FALSE,FALSE,1467050670,1467050670,0
216602,796,0,FALSE,FALSE,1449186173,1449186173,0
216603,797,0,FALSE,FALSE,1457007806,1457007806,0
216604,799,0,FALSE,FALSE,1450716347,1450716347,0
216605,800,0,FALSE,FALSE,1469212639,1469212639,0
216606,801,0,FALSE,FALSE,1450656578,1450656578,0
216607,802,0,FALSE,FALSE,1454943451,1454943451,0
216608,803,0,FALSE,FALSE,1468900940,1468900940,0
216609,804,0,FALSE,FALSE,1467819584,1467819584,0
216610,805,0,FALSE,FALSE,1483107429,1483107429,0
216611,806,0,FALSE,FALSE,1460966858,1460966858,0
216612,807,0,FALSE,FALSE,1456433071,1456433071,0
216614,809,0,FALSE,FALSE,1470304483,1470304483,0
216714,813,0,FALSE,FALSE,1478887466,1478887466,0
216715,814,0,FALSE,FALSE,1474241166,1474241166,0
216716,815,0,FALSE,FALSE,1448932297,1448932297,0
216717,818,0,FALSE,FALSE,1452810113,1452810113,0
216718,819,0,FALSE,FALSE,1468984924,1468984924,0
216719,820,0,FALSE,FALSE,1475767746,1475767746,0
216808,822,0,FALSE,FALSE,1458586241,1458586241,0
216809,824,0,FALSE,FALSE,1466044745,1466044745,0
216810,825,0,FALSE,FALSE,1457903337,1457903337,0
216811,826,0,FALSE,FALSE,1466617374,1466617374,0
216814,829,0,FALSE,FALSE,1456626680,1456626680,0
216815,830,0,FALSE,FALSE,1469733174,1469733174,0
216816,831,0,FALSE,FALSE,1471986601,1471986601,0
216817,832,0,FALSE,FALSE,1450631213,1450631213,0
216818,833,0,FALSE,FALSE,1470566955,1470566955,0
216819,834,0,FALSE,FALSE,1451330155,1451330155,0
216820,835,0,FALSE,FALSE,1453049991,1453049991,0
216821,838,0,FALSE,FALSE,1471792760,1471792760,0
216822,839,0,FALSE,FALSE,1459961379,1459961379,0
216823,840,0,FALSE,FALSE,1452431720,1452431720,0
216824,841,0,FALSE,FALSE,1454249793,1454249793,0
216825,842,0,FALSE,FALSE,1462844330,1462844330,0
216826,843,0,FALSE,FALSE,1450379872,1450379872,0
216827,844,0,FALSE,FALSE,1461228940,1461228940,0
216828,846,0,FALSE,FALSE,1479833282,1479833282,0
216829,847,0,FALSE,FALSE,1465590677,1465590677,0
216830,848,0,FALSE,FALSE,1460790275,1460790275,0
216838,850,0,FALSE,FALSE,1456811195,1456811195,0
216842,852,0,FALSE,FALSE,1456563541,1456563541,0
216843,853,0,FALSE,FALSE,1473042168,1473042168,0
216844,854,0,FALSE,FALSE,1481573036,1481573036,0
216845,855,0,FALSE,FALSE,1470255544,1470255544,0
216846,856,0,FALSE,FALSE,1462883844,1462883844,0
216847,857,0,FALSE,FALSE,1482338721,1482338721,0
216848,858,0,FALSE,FALSE,1460280104,1460280104,0
216849,859,0,FALSE,FALSE,1474358437,1474358437,0
216850,860,0,FALSE,FALSE,1474358437,1474358437,0
216867,862,0,FALSE,FALSE,1464529429,1464529429,0
216868,863,0,FALSE,FALSE,1460759543,1460759543,0
216869,864,0,FALSE,FALSE,1456286701,1456286701,0
216870,865,0,FALSE,FALSE,1450754171,1450754171,0
216871,866,0,FALSE,FALSE,1478102222,1478102222,0
216872,867,0,FALSE,FALSE,1477084476,1477084476,0
216873,868,0,FALSE,FALSE,1467058588,1467058588,0
216874,869,0,FALSE,FALSE,1450237225,1450237225,0
216879,872,0,FALSE,FALSE,1474993013,1474993013,0
216880,873,0,FALSE,FALSE,1452057647,1452057647,0
216881,874,0,FALSE,FALSE,1460040880,1460040880,0
216892,876,0,FALSE,FALSE,1462193712,1462193712,0
216893,877,0,FALSE,FALSE,1475597492,1475597492,0
216894,878,0,FALSE,FALSE,1460576040,1460576040,0
216897,880,0,FALSE,FALSE,1472587350,1472587350,0
216898,882,0,FALSE,FALSE,1470349586,1470349586,0
216899,883,0,FALSE,FALSE,1470349586,1470349586,0
216900,884,0,FALSE,FALSE,1478712372,1478712372,0
216901,885,0,FALSE,FALSE,1472065672,1472065672,0
216902,886,0,FALSE,FALSE,1452185911,1452185911,0
216903,887,0,FALSE,FALSE,1458719679,1458719679,0
216907,889,0,FALSE,FALSE,1467645881,1467645881,0
216908,890,0,FALSE,FALSE,1469413611,1469413611,0
216910,892,0,FALSE,FALSE,1473247680,1473247680,0
216911,895,0,FALSE,FALSE,1472429300,1472429300,0
216912,896,0,FALSE,FALSE,1450009850,1450009850,0
216913,897,0,FALSE,FALSE,1471568535,1471568535,0
216914,898,0,FALSE,FALSE,1470584279,1470584279,0
216915,899,0,FALSE,FALSE,1475768999,1475768999,0
216916,900,0,FALSE,FALSE,1450382275,1450382275,0
216917,901,0,FALSE,FALSE,1462436442,1462436442,0
216925,903,0,FALSE,FALSE,1469500817,1469500817,0
216926,904,0,FALSE,FALSE,1474288017,1474288017,0
216927,906,0,FALSE,FALSE,1463327941,1463327941,0
216928,907,0,FALSE,FALSE,1453844237,1453844237,0
216930,909,0,FALSE,FALSE,1472641071,1472641071,0
216931,910,0,FALSE,FALSE,1454000630,1454000630,0
216932,911,0,FALSE,FALSE,1454000630,1454000630,0
216935,913,0,FALSE,FALSE,1472197479,1472197479,0
216936,914,0,FALSE,FALSE,1462069896,1462069896,0
216937,915,0,FALSE,FALSE,1477096939,1477096939,0
216938,916,0,FALSE,FALSE,1455891299,1455891299,0
216939,917,0,FALSE,FALSE,1449297717,1449297717,0
216940,918,0,FALSE,FALSE,1453733636,1453733636,0
216941,919,0,FALSE,FALSE,1483177168,1483177168,0
216942,920,0,FALSE,FALSE,1475137296,1475137296,0
216943,921,0,FALSE,FALSE,1475137296,1475137296,0
216944,922,0,FALSE,FALSE,1451506064,1451506064,0
216945,923,0,FALSE,FALSE,1461332997,1461332997,0
216946,924,0,FALSE,FALSE,1475775893,1475775893,0
216947,925,0,FALSE,FALSE,1477255565,1477255565,0
216948,926,0,FALSE,FALSE,1452205524,1452205524,0
216950,928,0,FALSE,FALSE,1452194218,1452194218,0
216951,929,0,FALSE,FALSE,1454875546,1454875546,0
216952,930,0,FALSE,FALSE,1456261918,1456261918,0
216953,932,0,FALSE,FALSE,1458831274,1458831274,0
216954,933,0,FALSE,FALSE,1466906264,1466906264,0
216955,934,0,FALSE,FALSE,1470721720,1470721720,0
216956,935,0,FALSE,FALSE,1470721720,1470721720,0
216957,936,0,FALSE,FALSE,1455166856,1455166856,0
216958,937,0,FALSE,FALSE,1449882172,1449882172,0
216959,939,0,FALSE,FALSE,1452429681,1452429681,0
216960,940,0,FALSE,FALSE,1460677773,1460677773,0
216961,941,0,FALSE,FALSE,1482914186,1482914186,0
216962,943,0,FALSE,FALSE,1459967188,1459967188,0
216963,945,0,FALSE,FALSE,1455520968,1455520968,0
216964,946,0,FALSE,FALSE,1455520968,1455520968,0
216975,949,0,FALSE,FALSE,1451407354,1451407354,0
217028,952,0,FALSE,FALSE,1458600631,1458600631,0
217029,953,0,FALSE,FALSE,1457362372,1457362372,0
217030,954,0,FALSE,FALSE,1471492504,1471492504,0
217031,956,0,FALSE,FALSE,1472927708,1472927708,0
217032,957,0,FALSE,FALSE,1470939505,1470939505,0
217033,958,0,FALSE,FALSE,1451857929,1451857929,0
217034,959,0,FALSE,FALSE,1483376637,1483376637,0
217038,961,0,FALSE,FALSE,1449542408,1449542408,0
217040,964,0,FALSE,FALSE,1477854775,1477854775,0
217041,965,0,FALSE,FALSE,1454951006,1454951006,0
217042,966,0,FALSE,FALSE,1479472572,1479472572,0
217043,968,0,FALSE,FALSE,1470938780,1470938780,0
217044,969,0,FALSE,FALSE,1455465891,1455465891,0
217045,970,0,FALSE,FALSE,1449627887,1449627887,0
218330,972,0,FALSE,FALSE,1455299934,1455299934,0
218331,973,0,FALSE,FALSE,1457128164,1457128164,0
218332,974,0,FALSE,FALSE,1457128164,1457128164,0
218333,975,0,FALSE,FALSE,1480916281,1480916281,0
218339,977,0,FALSE,FALSE,1457701648,1457701648,0
218340,978,0,FALSE,FALSE,1481920121,1481920121,0
218341,979,0,FALSE,FALSE,1453576134,1453576134,0
218342,980,0,FALSE,FALSE,1476846387,1476846387,0
218343,981,0,FALSE,FALSE,1482951882,1482951882,0
218344,982,0,FALSE,FALSE,1450131089,1450131089,0
218345,983,0,FALSE,FALSE,1455899575,1455899575,0
218346,984,0,FALSE,FALSE,1465372399,1465372399,0
218347,985,0,FALSE,FALSE,1457123380,1457123380,0
218349,987,0,FALSE,FALSE,1458504067,1458504067,0
218350,988,0,FALSE,FALSE,1469652006,1469652006,0
218351,989,0,FALSE,FALSE,1469652006,1469652006,0
218352,990,0,FALSE,FALSE,1482444624,1482444624,0
218353,991,0,FALSE,FALSE,1476719180,1476719180,0
218354,992,0,FALSE,FALSE,1482429279,1482429279,0
218355,993,0,FALSE,FALSE,1470291175,1470291175,0
218356,994,0,FALSE,FALSE,1481304207,1481304207,0
218357,996,0,FALSE,FALSE,1449682975,1449682975,0
218358,997,0,FALSE,FALSE,1464362981,1464362981,0
218359,998,0,FALSE,FALSE,1467203378,1467203378,0
218360,1000,0,FALSE,FALSE,1459304786,1459304786,0
218361,1001,0,FALSE,FALSE,1469999156,1469999156,0
218362,1002,0,FALSE,FALSE,1475286016,1475286016,0
218363,1003,0,FALSE,FALSE,1464291350,1464291350,0
218366,1008,0,FALSE,FALSE,1449864029,1449864029,0
218367,1009,0,FALSE,FALSE,1460358894,1460358894,0
218368,1010,0,FALSE,FALSE,1471289112,1471289112,0
218369,1013,0,FALSE,FALSE,1459914088,1459914088,0
218370,1014,0,FALSE,FALSE,1457911532,1457911532,0
218371,1015,0,FALSE,FALSE,1465766330,1465766330,0
218372,1016,0,FALSE,FALSE,1464787898,1464787898,0
218373,1017,0,FALSE,FALSE,1476736666,1476736666,0
218375,1020,0,FALSE,FALSE,1471136596,1471136596,0
218379,1024,0,FALSE,FALSE,1458397612,1458397612,0
218380,1025,0,FALSE,FALSE,1462261923,1462261923,0
218483,1027,0,FALSE,FALSE,1470893385,1470893385,0
218484,1028,0,FALSE,FALSE,1470893385,1470893385,0
218485,1029,0,FALSE,FALSE,1474644705,1474644705,0
218486,1031,0,FALSE,FALSE,1453803680,1453803680,0
218487,1032,0,FALSE,FALSE,1453772517,1453772517,0
218488,1033,0,FALSE,FALSE,1453335792,1453335792,0
218489,1034,0,FALSE,FALSE,1464329019,1464329019,0
218490,1035,0,FALSE,FALSE,1473008772,1473008772,0
281479,1038,0,FALSE,FALSE,1466687734,1466687734,0
281489,1040,0,FALSE,FALSE,1463416274,1463416274,0
281490,1041,0,FALSE,FALSE,1454044882,1454044882,0
281491,1043,0,FALSE,FALSE,1469900073,1469900073,0
281492,1044,0,FALSE,FALSE,1471341802,1471341802,0
281493,1046,0,FALSE,FALSE,1449700268,1449700268,0
281494,1047,0,FALSE,FALSE,1466643202,1466643202,0
281495,1048,0,FALSE,FALSE,1481412216,1481412216,0
281496,1049,0,FALSE,FALSE,1479475678,1479475678,0
281497,1050,0,FALSE,FALSE,1455892378,1455892378,0
281498,1051,0,FALSE,FALSE,1469707369,1469707369,0
281499,1052,0,FALSE,FALSE,1457741908,1457741908,0
281500,1054,0,FALSE,FALSE,1460059240,1460059240,0
281501,1055,0,FALSE,FALSE,1478643352,1478643352,0
281517,1059,0,FALSE,FALSE,1468297697,1468297697,0
281518,1062,0,FALSE,FALSE,1471562805,1471562805,0
281519,1063,0,FALSE,FALSE,1468787674,1468787674,0
281520,1064,0,FALSE,FALSE,1451247808,1451247808,0
281574,1066,0,FALSE,FALSE,1462977004,1462977004,0
281575,1067,0,FALSE,FALSE,1474324991,1474324991,0
283525,1070,0,FALSE,FALSE,1471158921,1471158921,0
283526,1071,0,FALSE,FALSE,1471158921,1471158921,0
283540,1076,0,FALSE,FALSE,1453511673,1453511673,0
283541,1077,0,FALSE,FALSE,1463343305,1463343305,0
283542,1078,0,FALSE,FALSE,1449463206,1449463206,0
283543,1079,0,FALSE,FALSE,1478924328,1478924328,0
283546,1081,0,FALSE,FALSE,1452468202,1452468202,0
283547,1082,0,FALSE,FALSE,1452468202,1452468202,0
283548,1083,0,FALSE,FALSE,1464851317,1464851317,0
283549,1086,0,FALSE,FALSE,1455136533,1455136533,0
283550,1087,0,FALSE,FALSE,1450196482,1450196482,0
283551,1088,0,FALSE,FALSE,1473219688,1473219688,0
283552,1089,0,FALSE,FALSE,1455287837,1455287837,0
283553,1090,0,FALSE,FALSE,1465488115,1465488115,0
283554,1091,0,FALSE,FALSE,1481220393,1481220393,0
283555,1092,0,FALSE,FALSE,1464724572,1464724572,0
283557,1096,0,FALSE,FALSE,1480954894,1480954894,0
283558,1097,0,FALSE,FALSE,1470037918,1470037918,0
283563,1100,0,FALSE,FALSE,1455064600,1455064600,0
283564,1102,0,FALSE,FALSE,1478822302,1478822302,0
283572,1106,0,FALSE,FALSE,1464565750,1464565750,0
283573,1107,0,FALSE,FALSE,1459210686,1459210686,0
283574,1108,0,FALSE,FALSE,1463455667,1463455667,0
283575,1109,0,FALSE,FALSE,1478385618,1478385618,0
283576,1110,0,FALSE,FALSE,1466102300,1466102300,0
284351,1113,0,FALSE,FALSE,1460834446,1460834446,0
284352,1114,0,FALSE,FALSE,1460489546,1460489546,0
284354,1116,0,FALSE,FALSE,1453155127,1453155127,0
284355,1117,0,FALSE,FALSE,1457714619,1457714619,0
284628,1119,0,FALSE,FALSE,1461637586,1461637586,0
284629,1120,0,FALSE,FALSE,1462018161,1462018161,0
284630,1121,0,FALSE,FALSE,1455766192,1455766192,0
284631,1123,0,FALSE,FALSE,1450587781,1450587781,0
284632,1125,0,FALSE,FALSE,1452545680,1452545680,0
284633,1126,0,FALSE,FALSE,1473290261,1473290261,0
284634,1127,0,FALSE,FALSE,1483109764,1483109764,0
284635,1128,0,FALSE,FALSE,1468341446,1468341446,0
284636,1129,0,FALSE,FALSE,1470614309,1470614309,0
284637,1130,0,FALSE,FALSE,1470614309,1470614309,0
284638,1131,0,FALSE,FALSE,1449551569,1449551569,0
284639,1133,0,FALSE,FALSE,1467043088,1467043088,0
284640,1134,0,FALSE,FALSE,1461093676,1461093676,0
284641,1135,0,FALSE,FALSE,1475187905,1475187905,0
284642,1136,0,FALSE,FALSE,1453316212,1453316212,0
284643,1137,0,FALSE,FALSE,1470841746,1470841746,0
284644,1139,0,FALSE,FALSE,1454336538,1454336538,0
284645,1140,0,FALSE,FALSE,1462307455,1462307455,0
284647,1142,0,FALSE,FALSE,1474404134,1474404134,0
284648,1143,0,FALSE,FALSE,1474404134,1474404134,0
284649,1144,0,FALSE,FALSE,1458439322,1458439322,0
284650,1145,0,FALSE,FALSE,1471125641,1471125641,0
284651,1146,0,FALSE,FALSE,1460231784,1460231784,0
284652,1147,0,FALSE,FALSE,1471698144,1471698144,0
284653,1148,0,FALSE,FALSE,1462527473,1462527473,0
284654,1149,0,FALSE,FALSE,1478879682,1478879682,0
284655,1150,0,FALSE,FALSE,1472007160,1472007160,0
284660,1154,0,FALSE,FALSE,1469050241,1469050241,0
284661,1155,0,FALSE,FALSE,1473805544,1473805544,0
284662,1156,0,FALSE,FALSE,1464226263,1464226263,0
284663,1157,0,FALSE,FALSE,1459372559,1459372559,0
284664,1160,0,FALSE,FALSE,1465117310,1465117310,0
284665,1161,0,FALSE,FALSE,1456969551,1456969551,0
284668,1163,0,FALSE,FALSE,1472088689,1472088689,0
284669,1164,0,FALSE,FALSE,1451875035,1451875035,0
284670,1165,0,FALSE,FALSE,1449930892,1449930892,0
284671,1166,0,FALSE,FALSE,1459934141,1459934141,0
284672,1167,0,FALSE,FALSE,1475700596,1475700596,0
284673,1168,0,FALSE,FALSE,1475700596,1475700596,0
284684,1173,0,FALSE,FALSE,1458859419,1458859419,0
284685,1174,0,FALSE,FALSE,1453514489,1453514489,0
284686,1175,0,FALSE,FALSE,1465152344,1465152344,0
284687,1176,0,FALSE,FALSE,1470299921,1470299921,0
284689,1178,0,FALSE,FALSE,1453812714,1453812714,0
284690,1179,0,FALSE,FALSE,1467904795,1467904795,0
284691,1180,0,FALSE,FALSE,1467032178,1467032178,0
284692,1181,0,FALSE,FALSE,1471734099,1471734099,0
284693,1182,0,FALSE,FALSE,1458185763,1458185763,0
284694,1183,0,FALSE,FALSE,1451580723,1451580723,0
284695,1184,0,FALSE,FALSE,1469375818,1469375818,0
284696,1186,0,FALSE,FALSE,1471608392,1471608392,0
284697,1187,0,FALSE,FALSE,1455492766,1455492766,0
284701,1189,0,FALSE,FALSE,1472296678,1472296678,0
284709,1192,0,FALSE,FALSE,1450506773,1450506773,0
284710,1193,0,FALSE,FALSE,1450506785,1450506785,0
284711,1194,0,FALSE,FALSE,1450507436,1450507436,0
284712,1195,0,FALSE,FALSE,1456176178,1456176178,0
284713,1196,0,FALSE,FALSE,1468744480,1468744480,0
284714,1197,0,FALSE,FALSE,1475234930,1475234930,0
284715,1198,0,FALSE,FALSE,1468267019,1468267019,0
284716,1199,0,FALSE,FALSE,1456780366,1456780366,0
284717,1200,0,FALSE,FALSE,1456780366,1456780366,0
284718,1201,0,FALSE,FALSE,1455593544,1455593544,0
284719,1202,0,FALSE,FALSE,1471728252,1471728252,0
284720,1203,0,FALSE,FALSE,1472396448,1472396448,0
284721,1204,0,FALSE,FALSE,1465677355,1465677355,0
284722,1206,0,FALSE,FALSE,1465327000,1465327000,0
284723,1208,0,FALSE,FALSE,1468336101,1468336101,0
284724,1209,0,FALSE,FALSE,1464722920,1464722920,0
284728,1212,0,FALSE,FALSE,1457225379,1457225379,0
284729,1214,0,FALSE,FALSE,1464138737,1464138737,0
284963,1216,0,FALSE,FALSE,1469614445,1469614445,0
284964,1217,0,FALSE,FALSE,1450289815,1450289815,0
285015,1219,0,FALSE,FALSE,1466000197,1466000197,0
285042,1222,0,FALSE,FALSE,1471219619,1471219619,0
285043,1224,0,FALSE,FALSE,1478533210,1478533210,0
285044,1225,0,FALSE,FALSE,1457297177,1457297177,0
285045,1226,0,FALSE,FALSE,1452067373,1452067373,0
285046,1227,0,FALSE,FALSE,1478814308,1478814308,0
285047,1228,0,FALSE,FALSE,1457823504,1457823504,0
285048,1229,0,FALSE,FALSE,1449915817,1449915817,0
285049,1230,0,FALSE,FALSE,1462733680,1462733680,0
285050,1231,0,FALSE,FALSE,1461622489,1461622489,0
285051,1232,0,FALSE,FALSE,1470767988,1470767988,0
285052,1233,0,FALSE,FALSE,1478643409,1478643409,0
285053,1234,0,FALSE,FALSE,1480964855,1480964855,0
285054,1235,0,FALSE,FALSE,1474378165,1474378165,0
285055,1236,0,FALSE,FALSE,1471462933,1471462933,0
285056,1237,0,FALSE,FALSE,1452231882,1452231882,0
285057,1239,0,FALSE,FALSE,1478925571,1478925571,0
285058,1240,0,FALSE,FALSE,1448986560,1448986560,0
285059,1241,0,FALSE,FALSE,1459769266,1459769266,0
285063,1243,0,FALSE,FALSE,1454457944,1454457944,0
285064,1244,0,FALSE,FALSE,1471357463,1471357463,0
285065,1246,0,FALSE,FALSE,1465568724,1465568724,0
285071,1248,0,FALSE,FALSE,1473850160,1473850160,0
285072,1249,0,FALSE,FALSE,1464014708,1464014708,0
285073,1250,0,FALSE,FALSE,1469214130,1469214130,0
285074,1251,0,FALSE,FALSE,1469650372,1469650372,0
285075,1253,0,FALSE,FALSE,1472464752,1472464752,0
285076,1254,0,FALSE,FALSE,1465500914,1465500914,0
285077,1256,0,FALSE,FALSE,1452273746,1452273746,0
285078,1257,0,FALSE,FALSE,1473599169,1473599169,0
285079,1258,0,FALSE,FALSE,1482960984,1482960984,0
285080,1261,0,FALSE,FALSE,1456450486,1456450486,0
285081,1262,0,FALSE,FALSE,1471370402,1471370402,0
285082,1265,0,FALSE,FALSE,1482954292,1482954292,0
285156,1267,0,FALSE,FALSE,1453338174,1453338174,0
285157,1268,0,FALSE,FALSE,1478506914,1478506914,0
285158,1269,0,FALSE,FALSE,1475535739,1475535739,0
285159,1270,0,FALSE,FALSE,1470667961,1470667961,0
285160,1271,0,FALSE,FALSE,1452045353,1452045353,0
285161,1272,0,FALSE,FALSE,1455740502,1455740502,0
285177,1276,0,FALSE,FALSE,1464139340,1464139340,0
285178,1277,0,FALSE,FALSE,1469924447,1469924447,0
285179,1278,0,FALSE,FALSE,1458973085,1458973085,0
285180,1280,0,FALSE,FALSE,1450043396,1450043396,0
285181,1281,0,FALSE,FALSE,1468419384,1468419384,0
285182,1282,0,FALSE,FALSE,1475200006,1475200006,0
285183,1284,0,FALSE,FALSE,1452445852,1452445852,0
285238,1286,0,FALSE,FALSE,1470683245,1470683245,0
285239,1287,0,FALSE,FALSE,1455248406,1455248406,0
285242,1289,0,FALSE,FALSE,1462397738,1462397738,0
285243,1290,0,FALSE,FALSE,1464417534,1464417534,0
285244,1291,0,FALSE,FALSE,1476687494,1476687494,0
285245,1292,0,FALSE,FALSE,1469284188,1469284188,0
285246,1293,0,FALSE,FALSE,1468245348,1468245348,0
285247,1294,0,FALSE,FALSE,1467654125,1467654125,0
285248,1295,0,FALSE,FALSE,1478389085,1478389085,0
285249,1296,0,FALSE,FALSE,1472158922,1472158922,0
285250,1297,0,FALSE,FALSE,1458704435,1458704435,0
285251,1298,0,FALSE,FALSE,1459356053,1459356053,0
285266,1301,0,FALSE,FALSE,1451983390,1451983390,0
285267,1302,0,FALSE,FALSE,1466285714,1466285714,0
285268,1303,0,FALSE,FALSE,1466285714,1466285714,0
285269,1304,0,FALSE,FALSE,1481607881,1481607881,0
285270,1305,0,FALSE,FALSE,1459690486,1459690486,0
285272,1307,0,FALSE,FALSE,1452697172,1452697172,0
285273,1308,0,FALSE,FALSE,1471488760,1471488760,0
285274,1309,0,FALSE,FALSE,1449682302,1449682302,0
285275,1310,0,FALSE,FALSE,1472487658,1472487658,0
285276,1311,0,FALSE,FALSE,1460730138,1460730138,0
285277,1312,0,FALSE,FALSE,1449843309,1449843309,0
285278,1314,0,FALSE,FALSE,1452297432,1452297432,0
285279,1315,0,FALSE,FALSE,1478458981,1478458981,0
285280,1316,0,FALSE,FALSE,1455283455,1455283455,0
285281,1317,0,FALSE,FALSE,1480832777,1480832777,0
285282,1318,0,FALSE,FALSE,1451367282,1451367282,0
285283,1319,0,FALSE,FALSE,1478502419,1478502419,0
285284,1320,0,FALSE,FALSE,1471885819,1471885819,0
285711,1324,0,FALSE,FALSE,1454786022,1454786022,0
285712,1325,0,FALSE,FALSE,1479236544,1479236544,0
285713,1326,0,FALSE,FALSE,1463095844,1463095844,0
285836,1329,0,FALSE,FALSE,1461875947,1461875947,0
285891,1331,0,FALSE,FALSE,1453142428,1453142428,0
285892,1332,0,FALSE,FALSE,1457455361,1457455361,0
285893,1334,0,FALSE,FALSE,1458143100,1458143100,0
285894,1335,0,FALSE,FALSE,1476277614,1476277614,0
285895,1336,0,FALSE,FALSE,1474636326,1474636326,0
285896,1338,0,FALSE,FALSE,1464757617,1464757617,0
285897,1339,0,FALSE,FALSE,1470350282,1470350282,0
285898,1340,0,FALSE,FALSE,1470350282,1470350282,0
285899,1341,0,FALSE,FALSE,1460064512,1460064512,0
285900,1342,0,FALSE,FALSE,1466997541,1466997541,0
285901,1343,0,FALSE,FALSE,1472909097,1472909097,0
286781,1345,0,FALSE,FALSE,1471413319,1471413319,0
286782,1346,0,FALSE,FALSE,1467281794,1467281794,0
286783,1347,0,FALSE,FALSE,1462553215,1462553215,0
286784,1348,0,FALSE,FALSE,1480363030,1480363030,0
286787,1351,0,FALSE,FALSE,1451950369,1451950369,0
286817,1354,0,FALSE,FALSE,1458825765,1458825765,0
286818,1355,0,FALSE,FALSE,1466485518,1466485518,0
286819,1356,0,FALSE,FALSE,1482953157,1482953157,0
286820,1358,0,FALSE,FALSE,1463524706,1463524706,0
286821,1359,0,FALSE,FALSE,1476693314,1476693314,0
286822,1361,0,FALSE,FALSE,1468903240,1468903240,0
286823,1362,0,FALSE,FALSE,1481412686,1481412686,0
286824,1363,0,FALSE,FALSE,1472671890,1472671890,0
286825,1364,0,FALSE,FALSE,1458605073,1458605073,0
286826,1366,0,FALSE,FALSE,1475149693,1475149693,0
286827,1368,0,FALSE,FALSE,1464823902,1464823902,0
286828,1370,0,FALSE,FALSE,1470023501,1470023501,0
286829,1371,0,FALSE,FALSE,1460045237,1460045237,0
286888,1373,0,FALSE,FALSE,1468861761,1468861761,0
286889,1374,0,FALSE,FALSE,1465060046,1465060046,0
286890,1375,0,FALSE,FALSE,1472005399,1472005399,0
286891,1376,0,FALSE,FALSE,1465415614,1465415614,0
286892,1377,0,FALSE,FALSE,1478933241,1478933241,0
286893,1378,0,FALSE,FALSE,1460988653,1460988653,0
286894,1379,0,FALSE,FALSE,1468446649,1468446649,0
286895,1380,0,FALSE,FALSE,1451893000,1451893000,0
286896,1381,0,FALSE,FALSE,1451689972,1451689972,0
286899,1383,0,FALSE,FALSE,1454660424,1454660424,0
286900,1384,0,FALSE,FALSE,1472523276,1472523276,0
286901,1385,0,FALSE,FALSE,1452195295,1452195295,0
286902,1386,0,FALSE,FALSE,1461444737,1461444737,0
286903,1387,0,FALSE,FALSE,1452457183,1452457183,0
286904,1388,0,FALSE,FALSE,1460043709,1460043709,0
286905,1389,0,FALSE,FALSE,1480542944,1480542944,0
286906,1390,0,FALSE,FALSE,1449672233,1449672233,0
286907,1391,0,FALSE,FALSE,1465476355,1465476355,0
286910,1394,0,FALSE,FALSE,1452862714,1452862714,0
286911,1395,0,FALSE,FALSE,1472115948,1472115948,0
286912,1396,0,FALSE,FALSE,1475272489,1475272489,0
286913,1397,0,FALSE,FALSE,1467792529,1467792529,0
286916,1399,0,FALSE,FALSE,1466445607,1466445607,0
286917,1400,0,FALSE,FALSE,1454905836,1454905836,0
286918,1401,0,FALSE,FALSE,1463414890,1463414890,0
286919,1402,0,FALSE,FALSE,1454595439,1454595439,0
286996,1405,0,FALSE,FALSE,1477416265,1477416265,0
286997,1406,0,FALSE,FALSE,1476723434,1476723434,0
286998,1407,0,FALSE,FALSE,1461140251,1461140251,0
286999,1408,0,FALSE,FALSE,1449846074,1449846074,0
287000,1409,0,FALSE,FALSE,1476713006,1476713006,0
287001,1410,0,FALSE,FALSE,1450993309,1450993309,0
287016,1413,0,FALSE,FALSE,1475357318,1475357318,0
287017,1414,0,FALSE,FALSE,1482867437,1482867437,0
287066,1417,0,FALSE,FALSE,1460950981,1460950981,0
287095,1420,0,FALSE,FALSE,1467936655,1467936655,0
287096,1422,0,FALSE,FALSE,1460792754,1460792754,0
287097,1423,0,FALSE,FALSE,1464981889,1464981889,0
287098,1424,0,FALSE,FALSE,1454034001,1454034001,0
287099,1425,0,FALSE,FALSE,1472675019,1472675019,0
287100,1426,0,FALSE,FALSE,1463458558,1463458558,0
287101,1427,0,FALSE,FALSE,1481430941,1481430941,0
287102,1428,0,FALSE,FALSE,1467302853,1467302853,0
287103,1429,0,FALSE,FALSE,1468937624,1468937624,0
287104,1432,0,FALSE,FALSE,1454122959,1454122959,0
287105,1433,0,FALSE,FALSE,1454122959,1454122959,0
287106,1434,0,FALSE,FALSE,1478336982,1478336982,0
287107,1435,0,FALSE,FALSE,1458886422,1458886422,0
287110,1437,0,FALSE,FALSE,1456235519,1456235519,0
287111,1438,0,FALSE,FALSE,1455758958,1455758958,0
287112,1439,0,FALSE,FALSE,1477577771,1477577771,0
287113,1440,0,FALSE,FALSE,1466775326,1466775326,0
287114,1441,0,FALSE,FALSE,1475908471,1475908471,0
287115,1442,0,FALSE,FALSE,1478394375,1478394375,0
287116,1443,0,FALSE,FALSE,1465568313,1465568313,0
287117,1444,0,FALSE,FALSE,1450662120,1450662120,0
287216,1446,0,FALSE,FALSE,1472016610,1472016610,0
287267,1449,0,FALSE,FALSE,1452563266,1452563266,0
287268,1450,0,FALSE,FALSE,1470447508,1470447508,0
287269,1451,0,FALSE,FALSE,1480477009,1480477009,0
287270,1452,0,FALSE,FALSE,1479756056,1479756056,0
287271,1453,0,FALSE,FALSE,1461704802,1461704802,0
287272,1454,0,FALSE,FALSE,1480528062,1480528062,0
287273,1455,0,FALSE,FALSE,1450578642,1450578642,0
287274,1456,0,FALSE,FALSE,1477283897,1477283897,0
287325,1458,0,FALSE,FALSE,1480635781,1480635781,0
287326,1459,0,FALSE,FALSE,1457730128,1457730128,0
287327,1460,0,FALSE,FALSE,1455131005,1455131005,0
287328,1461,0,FALSE,FALSE,1481334444,1481334444,0
287333,1463,0,FALSE,FALSE,1465092929,1465092929,0
287334,1464,0,FALSE,FALSE,1468073350,1468073350,0
287352,1466,0,FALSE,FALSE,1452274289,1452274289,0
287353,1468,0,FALSE,FALSE,1472912674,1472912674,0
287354,1469,0,FALSE,FALSE,1464375282,1464375282,0
287355,1470,0,FALSE,FALSE,1468266925,1468266925,0
287356,1471,0,FALSE,FALSE,1455587915,1455587915,0
287392,1473,0,FALSE,FALSE,1472906676,1472906676,0
287393,1474,0,FALSE,FALSE,1459190430,1459190430,0
287394,1475,0,FALSE,FALSE,1476614828,1476614828,0
287395,1476,0,FALSE,FALSE,1454700236,1454700236,0
287396,1477,0,FALSE,FALSE,1453793705,1453793705,0
287397,1478,0,FALSE,FALSE,1455126558,1455126558,0
287398,1480,0,FALSE,FALSE,1470174415,1470174415,0
287399,1481,0,FALSE,FALSE,1453233002,1453233002,0
287400,1482,0,FALSE,FALSE,1449165593,1449165593,0
287401,1483,0,FALSE,FALSE,1453325470,1453325470,0
287402,1484,0,FALSE,FALSE,1453884257,1453884257,0
287406,1486,0,FALSE,FALSE,1468604983,1468604983,0
287407,1487,0,FALSE,FALSE,1470709500,1470709500,0
287408,1488,0,FALSE,FALSE,1453687830,1453687830,0
287409,1489,0,FALSE,FALSE,1469274868,1469274868,0
287446,1491,0,FALSE,FALSE,1457713373,1457713373,0
287447,1492,0,FALSE,FALSE,1467125627,1467125627,0
287448,1493,0,FALSE,FALSE,1460335273,1460335273,0
287449,1494,0,FALSE,FALSE,1459505965,1459505965,0
287450,1495,0,FALSE,FALSE,1481730648,1481730648,0
287451,1496,0,FALSE,FALSE,1456873199,1456873199,0
287457,1498,0,FALSE,FALSE,1450657777,1450657777,0
287458,1499,0,FALSE,FALSE,1476101292,1476101292,0
287462,1502,0,FALSE,FALSE,1464879023,1464879023,0
287463,1503,0,FALSE,FALSE,1471447677,1471447677,0
287464,1504,0,FALSE,FALSE,1462789391,1462789391,0
287465,1506,0,FALSE,FALSE,1455037584,1455037584,0
287549,1508,0,FALSE,FALSE,1465162007,1465162007,0
287550,1509,0,FALSE,FALSE,1482193968,1482193968,0
287551,1510,0,FALSE,FALSE,1470206776,1470206776,0
287552,1511,0,FALSE,FALSE,1449587434,1449587434,0
287553,1513,0,FALSE,FALSE,1474559923,1474559923,0
287554,1514,0,FALSE,FALSE,1454340557,1454340557,0
287560,1517,0,FALSE,FALSE,1457736482,1457736482,0
287562,1519,0,FALSE,FALSE,1479403013,1479403013,0
287563,1520,0,FALSE,FALSE,1475002146,1475002146,0
287601,1524,0,FALSE,FALSE,1482428439,1482428439,0
287617,1526,0,FALSE,FALSE,1476238369,1476238369,0
287619,1528,0,FALSE,FALSE,1474068879,1474068879,0
287620,1529,0,FALSE,FALSE,1480389076,1480389076,0
287621,1530,0,FALSE,FALSE,1460956827,1460956827,0
287622,1531,0,FALSE,FALSE,1465316228,1465316228,0
287623,1532,0,FALSE,FALSE,1459278823,1459278823,0
287624,1533,0,FALSE,FALSE,1459322000,1459322000,0
287625,1534,0,FALSE,FALSE,1458997384,1458997384,0
287626,1535,0,FALSE,FALSE,1449581465,1449581465,0
287627,1536,0,FALSE,FALSE,1460386616,1460386616,0
287629,1539,0,FALSE,FALSE,1468489455,1468489455,0
287816,1543,0,FALSE,FALSE,1481120013,1481120013,0
287817,1544,0,FALSE,FALSE,1461873345,1461873345,0
287818,1545,0,FALSE,FALSE,1480367409,1480367409,0
287819,1546,0,FALSE,FALSE,1458331810,1458331810,0
287820,1547,0,FALSE,FALSE,1475193877,1475193877,0
287824,1549,0,FALSE,FALSE,1467227905,1467227905,0
287825,1550,0,FALSE,FALSE,1460881003,1460881003,0
287826,1551,0,FALSE,FALSE,1468978082,1468978082,0
287827,1552,0,FALSE,FALSE,1470219278,1470219278,0
287828,1553,0,FALSE,FALSE,1455523041,1455523041,0
287829,1554,0,FALSE,FALSE,1451665076,1451665076,0
287830,1555,0,FALSE,FALSE,1453813264,1453813264,0
287831,1556,0,FALSE,FALSE,1481896844,1481896844,0
287832,1557,0,FALSE,FALSE,1477422678,1477422678,0
287833,1558,0,FALSE,FALSE,1467330443,1467330443,0
287834,1559,0,FALSE,FALSE,1460231427,1460231427,0
287835,1561,0,FALSE,FALSE,1453856916,1453856916,0
287836,1562,0,FALSE,FALSE,1473671841,1473671841,0
287837,1563,0,FALSE,FALSE,1452889543,1452889543,0
344466,1565,0,FALSE,FALSE,1461786104,1461786104,0
344467,1566,0,FALSE,FALSE,1478352336,1478352336,0
344468,1567,0,FALSE,FALSE,1474087248,1474087248,0
344469,1568,0,FALSE,FALSE,1450386742,1450386742,0
344470,1569,0,FALSE,FALSE,1460930668,1460930668,0
344471,1570,0,FALSE,FALSE,1466176939,1466176939,0
344472,1571,0,FALSE,FALSE,1483040257,1483040257,0
344484,1573,0,FALSE,FALSE,1475497868,1475497868,0
344485,1574,0,FALSE,FALSE,1481317996,1481317996,0
344486,1575,0,FALSE,FALSE,1471736812,1471736812,0
344487,1576,0,FALSE,FALSE,1468506865,1468506865,0
344488,1577,0,FALSE,FALSE,1464669870,1464669870,0
344489,1578,0,FALSE,FALSE,1451778368,1451778368,0
344493,1580,0,FALSE,FALSE,1469549212,1469549212,0
344494,1581,0,FALSE,FALSE,1460375295,1460375295,0
344566,1583,0,FALSE,FALSE,1451048555,1451048555,0
344567,1584,0,FALSE,FALSE,1471153991,1471153991,0
344575,1587,0,FALSE,FALSE,1477164033,1477164033,0
344576,1588,0,FALSE,FALSE,1477164033,1477164033,0
344577,1589,0,FALSE,FALSE,1453135408,1453135408,0
344578,1590,0,FALSE,FALSE,1460641243,1460641243,0
344579,1591,0,FALSE,FALSE,1482761208,1482761208,0
344580,1593,0,FALSE,FALSE,1465784511,1465784511,0
344581,1595,0,FALSE,FALSE,1474375691,1474375691,0
344586,1597,0,FALSE,FALSE,1467569730,1467569730,0
344587,1598,0,FALSE,FALSE,1465567145,1465567145,0
344588,1599,0,FALSE,FALSE,1468933998,1468933998,0
344589,1600,0,FALSE,FALSE,1478915243,1478915243,0
344590,1601,0,FALSE,FALSE,1481984447,1481984447,0
354401,1604,0,FALSE,FALSE,1478723282,1478723282,0
354402,1605,0,FALSE,FALSE,1467392046,1467392046,0
354988,1607,0,FALSE,FALSE,1478870391,1478870391,0
354989,1608,0,FALSE,FALSE,1477691921,1477691921,0
354990,1609,0,FALSE,FALSE,1452262216,1452262216,0
354991,1610,0,FALSE,FALSE,1452005833,1452005833,0
354992,1611,0,FALSE,FALSE,1475207832,1475207832,0
354993,1612,0,FALSE,FALSE,1465933774,1465933774,0
354995,1615,0,FALSE,FALSE,1466875293,1466875293,0
354996,1616,0,FALSE,FALSE,1481683083,1481683083,0
354997,1617,0,FALSE,FALSE,1459798987,1459798987,0
354998,1618,0,FALSE,FALSE,1473278556,1473278556,0
354999,1619,0,FALSE,FALSE,1476557704,1476557704,0
355000,1620,0,FALSE,FALSE,1460120421,1460120421,0
355001,1623,0,FALSE,FALSE,1479600795,1479600795,0
355002,1624,0,FALSE,FALSE,1470938742,1470938742,0
355003,1625,0,FALSE,FALSE,1464123136,1464123136,0
355004,1626,0,FALSE,FALSE,1462212460,1462212460,0
355008,1628,0,FALSE,FALSE,1466175512,1466175512,0
355009,1629,0,FALSE,FALSE,1469860625,1469860625,0
355010,1630,0,FALSE,FALSE,1469860625,1469860625,0
355011,1631,0,FALSE,FALSE,1465494066,1465494066,0
355012,1632,0,FALSE,FALSE,1475659876,1475659876,0
355013,1633,0,FALSE,FALSE,1475659876,1475659876,0
355014,1634,0,FALSE,FALSE,1481360938,1481360938,0
355015,1636,0,FALSE,FALSE,1467950216,1467950216,0
355019,1640,0,FALSE,FALSE,1450009826,1450009826,0
355020,1643,0,FALSE,FALSE,1459676413,1459676413,0
355021,1644,0,FALSE,FALSE,1468257217,1468257217,0
355022,1645,0,FALSE,FALSE,1477377878,1477377878,0
355023,1646,0,FALSE,FALSE,1467200661,1467200661,0
355024,1648,0,FALSE,FALSE,1453937796,1453937796,0
355025,1649,0,FALSE,FALSE,1477152468,1477152468,0
355026,1650,0,FALSE,FALSE,1463934031,1463934031,0
355027,1651,0,FALSE,FALSE,1455481322,1455481322,0
355038,1654,0,FALSE,FALSE,1464123149,1464123149,0
355039,1655,0,FALSE,FALSE,1466978313,1466978313,0
355040,1657,0,FALSE,FALSE,1460652768,1460652768,0
355041,1658,0,FALSE,FALSE,1470270663,1470270663,0
355042,1659,0,FALSE,FALSE,1474639709,1474639709,0
355043,1660,0,FALSE,FALSE,1473717289,1473717289,0
355044,1661,0,FALSE,FALSE,1465510554,1465510554,0
355045,1662,0,FALSE,FALSE,1474214047,1474214047,0
355046,1663,0,FALSE,FALSE,1454605821,1454605821,0
355047,1665,0,FALSE,FALSE,1475860550,1475860550,0
355048,1666,0,FALSE,FALSE,1449723295,1449723295,0
355049,1667,0,FALSE,FALSE,1472334497,1472334497,0
355066,1669,0,FALSE,FALSE,1460059969,1460059969,0
355067,1670,0,FALSE,FALSE,1462120570,1462120570,0
355068,1671,0,FALSE,FALSE,1456793162,1456793162,0
355069,1672,0,FALSE,FALSE,1452027166,1452027166,0
355070,1673,0,FALSE,FALSE,1477913645,1477913645,0
355071,1675,0,FALSE,FALSE,1461849940,1461849940,0
355072,1676,0,FALSE,FALSE,1476726135,1476726135,0
355073,1677,0,FALSE,FALSE,1451913314,1451913314,0
355074,1678,0,FALSE,FALSE,1454018721,1454018721,0
355075,1679,0,FALSE,FALSE,1470573530,1470573530,0
355076,1680,0,FALSE,FALSE,1459215603,1459215603,0
355077,1681,0,FALSE,FALSE,1472880395,1472880395,0
355078,1683,0,FALSE,FALSE,1472222991,1472222991,0
355079,1684,0,FALSE,FALSE,1479594431,1479594431,0
355092,1686,0,FALSE,FALSE,1460418694,1460418694,0
355093,1689,0,FALSE,FALSE,1451813390,1451813390,0
355094,1690,0,FALSE,FALSE,1474753877,1474753877,0
355096,1692,0,FALSE,FALSE,1461773373,1461773373,0
355097,1693,0,FALSE,FALSE,1481582562,1481582562,0
355098,1696,0,FALSE,FALSE,1461160495,1461160495,0
355104,1698,0,FALSE,FALSE,1462833672,1462833672,0
355106,1700,0,FALSE,FALSE,1452632806,1452632806,0
355110,1702,0,FALSE,FALSE,1451488290,1451488290,0
355111,1703,0,FALSE,FALSE,1460664710,1460664710,0
355112,1704,0,FALSE,FALSE,1476592645,1476592645,0
355113,1705,0,FALSE,FALSE,1476592645,1476592645,0
355137,1708,0,FALSE,FALSE,1464488460,1464488460,0
355142,1712,0,FALSE,FALSE,1480619584,1480619584,0
355143,1713,0,FALSE,FALSE,1456265575,1456265575,0
355144,1714,0,FALSE,FALSE,1453752639,1453752639,0
355145,1715,0,FALSE,FALSE,1466455674,1466455674,0
355146,1716,0,FALSE,FALSE,1480693085,1480693085,0
355150,1719,0,FALSE,FALSE,1455057446,1455057446,0
355151,1720,0,FALSE,FALSE,1466357795,1466357795,0
355152,1722,0,FALSE,FALSE,1477943387,1477943387,0
355153,1723,0,FALSE,FALSE,1451062138,1451062138,0
355154,1724,0,FALSE,FALSE,1481548885,1481548885,0
355155,1725,0,FALSE,FALSE,1466936120,1466936120,0
355156,1726,0,FALSE,FALSE,1471360740,1471360740,0
355157,1728,0,FALSE,FALSE,1463970631,1463970631,0
355158,1729,0,FALSE,FALSE,1457883797,1457883797,0
355159,1730,0,FALSE,FALSE,1475000360,1475000360,0
355160,1731,0,FALSE,FALSE,1454183548,1454183548,0
355161,1732,0,FALSE,FALSE,1464489252,1464489252,0
355162,1733,0,FALSE,FALSE,1460295124,1460295124,0
355172,1735,0,FALSE,FALSE,1462986949,1462986949,0
355173,1737,0,FALSE,FALSE,1469095433,1469095433,0
355174,1738,0,FALSE,FALSE,1450460840,1450460840,0
355175,1739,0,FALSE,FALSE,1466009092,1466009092,0
355176,1740,0,FALSE,FALSE,1472561670,1472561670,0
355177,1742,0,FALSE,FALSE,1480878107,1480878107,0
355178,1743,0,FALSE,FALSE,1463414428,1463414428,0
355179,1744,0,FALSE,FALSE,1474775054,1474775054,0
355191,1746,0,FALSE,FALSE,1477069950,1477069950,0
355192,1747,0,FALSE,FALSE,1466124316,1466124316,0
355193,1748,0,FALSE,FALSE,1473833440,1473833440,0
355194,1749,0,FALSE,FALSE,1450163927,1450163927,0
355195,1750,0,FALSE,FALSE,1481245078,1481245078,0
355196,1751,0,FALSE,FALSE,1462973837,1462973837,0
355197,1752,0,FALSE,FALSE,1483307702,1483307702,0
355198,1753,0,FALSE,FALSE,1449255368,1449255368,0
355199,1755,0,FALSE,FALSE,1461860583,1461860583,0
355200,1756,0,FALSE,FALSE,1453065677,1453065677,0
355201,1757,0,FALSE,FALSE,1461671717,1461671717,0
355203,1760,0,FALSE,FALSE,1482979923,1482979923,0
355204,1761,0,FALSE,FALSE,1454610460,1454610460,0
355205,1762,0,FALSE,FALSE,1466592401,1466592401,0
355206,1763,0,FALSE,FALSE,1452299685,1452299685,0
355212,1765,0,FALSE,FALSE,1471934470,1471934470,0
355213,1766,0,FALSE,FALSE,1469127199,1469127199,0
355214,1767,0,FALSE,FALSE,1468395137,1468395137,0
355215,1768,0,FALSE,FALSE,1459004857,1459004857,0
355216,1769,0,FALSE,FALSE,1452067943,1452067943,0
355217,1770,0,FALSE,FALSE,1457233125,1457233125,0
355218,1772,0,FALSE,FALSE,1469612724,1469612724,0
355219,1773,0,FALSE,FALSE,1465316271,1465316271,0
355220,1774,0,FALSE,FALSE,1464452458,1464452458,0
355221,1775,0,FALSE,FALSE,1453403805,1453403805,0
355222,1778,0,FALSE,FALSE,1461589052,1461589052,0
355223,1780,0,FALSE,FALSE,1461860448,1461860448,0
355224,1781,0,FALSE,FALSE,1458782683,1458782683,0
355263,1784,0,FALSE,FALSE,1475616337,1475616337,0
355264,1785,0,FALSE,FALSE,1479931528,1479931528,0
355272,1789,0,FALSE,FALSE,1468488038,1468488038,0
355273,1790,0,FALSE,FALSE,1454632969,1454632969,0
355274,1791,0,FALSE,FALSE,1476695510,1476695510,0
355275,1792,0,FALSE,FALSE,1478967966,1478967966,0
355276,1793,0,FALSE,FALSE,1479727253,1479727253,0
355277,1794,0,FALSE,FALSE,1472769865,1472769865,0
355278,1795,0,FALSE,FALSE,1451869892,1451869892,0
355279,1796,0,FALSE,FALSE,1453909580,1453909580,0
355697,1799,0,FALSE,FALSE,1470625416,1470625416,0
355698,1800,0,FALSE,FALSE,1467142092,1467142092,0
355699,1801,0,FALSE,FALSE,1462970942,1462970942,0
356637,1803,0,FALSE,FALSE,1482296612,1482296612,0
356642,1805,0,FALSE,FALSE,1483455578,1483455578,0
356643,1806,0,FALSE,FALSE,1467834692,1467834692,0
356644,1807,0,FALSE,FALSE,1465011496,1465011496,0
356645,1808,0,FALSE,FALSE,1474042779,1474042779,0
356646,1809,0,FALSE,FALSE,1458567121,1458567121,0
356647,1810,0,FALSE,FALSE,1452633538,1452633538,0
356648,1811,0,FALSE,FALSE,1452973357,1452973357,0
356649,1812,0,FALSE,FALSE,1454174734,1454174734,0
356653,1815,0,FALSE,FALSE,1452955880,1452955880,0
356654,1816,0,FALSE,FALSE,1451178981,1451178981,0
356655,1817,0,FALSE,FALSE,1473710030,1473710030,0
356656,1818,0,FALSE,FALSE,1477618760,1477618760,0
356657,1819,0,FALSE,FALSE,1461979454,1461979454,0
356658,1820,0,FALSE,FALSE,1460939931,1460939931,0
356659,1821,0,FALSE,FALSE,1472259586,1472259586,0
356660,1822,0,FALSE,FALSE,1451277974,1451277974,0
356661,1823,0,FALSE,FALSE,1463527421,1463527421,0
356662,1825,0,FALSE,FALSE,1466474198,1466474198,0
356663,1826,0,FALSE,FALSE,1455658183,1455658183,0
356664,1827,0,FALSE,FALSE,1483060727,1483060727,0
356666,1830,0,FALSE,FALSE,1454297902,1454297902,0
356667,1831,0,FALSE,FALSE,1482044685,1482044685,0
398577,1836,0,FALSE,FALSE,1452517342,1452517342,0
398578,1837,0,FALSE,FALSE,1451395295,1451395295,0
398579,1838,0,FALSE,FALSE,1460162102,1460162102,0
398609,1841,0,FALSE,FALSE,1472919231,1472919231,0
398610,1842,0,FALSE,FALSE,1455500824,1455500824,0
398611,1843,0,FALSE,FALSE,1454345221,1454345221,0
398612,1845,0,FALSE,FALSE,1466190291,1466190291,0
398613,1846,0,FALSE,FALSE,1473783615,1473783615,0
398614,1847,0,FALSE,FALSE,1452505648,1452505648,0
398615,1848,0,FALSE,FALSE,1462313291,1462313291,0
398616,1849,0,FALSE,FALSE,1478898446,1478898446,0
398617,1850,0,FALSE,FALSE,1466982871,1466982871,0
398618,1851,0,FALSE,FALSE,1479404167,1479404167,0
398619,1852,0,FALSE,FALSE,1477878076,1477878076,0
398620,1853,0,FALSE,FALSE,1458595479,1458595479,0
398621,1854,0,FALSE,FALSE,1479392865,1479392865,0
398622,1855,0,FALSE,FALSE,1451359469,1451359469,0
398623,1856,0,FALSE,FALSE,1452864093,1452864093,0
398812,1859,0,FALSE,FALSE,1480728358,1480728358,0
398813,1860,0,FALSE,FALSE,1461849817,1461849817,0
398816,1862,0,FALSE,FALSE,1470280954,1470280954,0
398817,1863,0,FALSE,FALSE,1472741504,1472741504,0
398818,1864,0,FALSE,FALSE,1471276576,1471276576,0
398819,1865,0,FALSE,FALSE,1461780422,1461780422,0
398820,1866,0,FALSE,FALSE,1481920627,1481920627,0
398821,1867,0,FALSE,FALSE,1477155797,1477155797,0
398822,1868,0,FALSE,FALSE,1450434275,1450434275,0
398823,1870,0,FALSE,FALSE,1456435296,1456435296,0
398829,1873,0,FALSE,FALSE,1465756898,1465756898,0
398830,1874,0,FALSE,FALSE,1481208039,1481208039,0
398980,1877,0,FALSE,FALSE,1475849470,1475849470,0
398981,1878,0,FALSE,FALSE,1460755978,1460755978,0
398982,1879,0,FALSE,FALSE,1477090937,1477090937,0
398983,1880,0,FALSE,FALSE,1462437155,1462437155,0
398984,1881,0,FALSE,FALSE,1452828945,1452828945,0
399815,1883,0,FALSE,FALSE,1451765140,1451765140,0
399816,1884,0,FALSE,FALSE,1451765140,1451765140,0
399817,1885,0,FALSE,FALSE,1482573433,1482573433,0
399823,1888,0,FALSE,FALSE,1482618306,1482618306,0
399824,1889,0,FALSE,FALSE,1462212515,1462212515,0
399825,1890,0,FALSE,FALSE,1453302580,1453302580,0
399826,1891,0,FALSE,FALSE,1452230757,1452230757,0
454673,1895,0,FALSE,FALSE,1472611925,1472611925,0
454674,1896,0,FALSE,FALSE,1480366118,1480366118,0
454675,1897,0,FALSE,FALSE,1465968614,1465968614,0
454676,1898,0,FALSE,FALSE,1466742030,1466742030,0
454677,1899,0,FALSE,FALSE,1457196502,1457196502,0
454678,1900,0,FALSE,FALSE,1459219637,1459219637,0
454679,1902,0,FALSE,FALSE,1470593187,1470593187,0
454680,1903,0,FALSE,FALSE,1453323420,1453323420,0
454681,1904,0,FALSE,FALSE,1475396832,1475396832,0
454682,1905,0,FALSE,FALSE,1453785709,1453785709,0
454683,1906,0,FALSE,FALSE,1472059814,1472059814,0
454685,1908,0,FALSE,FALSE,1465213820,1465213820,0
454686,1909,0,FALSE,FALSE,1480161982,1480161982,0
454687,1910,0,FALSE,FALSE,1471928706,1471928706,0
454688,1911,0,FALSE,FALSE,1458236973,1458236973,0
454689,1912,0,FALSE,FALSE,1463466413,1463466413,0
454729,1914,0,FALSE,FALSE,1466704422,1466704422,0
454730,1915,0,FALSE,FALSE,1478648697,1478648697,0
454731,1916,0,FALSE,FALSE,1464462650,1464462650,0
454732,1917,0,FALSE,FALSE,1468704873,1468704873,0
454733,1918,0,FALSE,FALSE,1477354891,1477354891,0
454736,1920,0,FALSE,FALSE,1464798081,1464798081,0
454737,1921,0,FALSE,FALSE,1451682335,1451682335,0
454738,1923,0,FALSE,FALSE,1459230517,1459230517,0
454739,1924,0,FALSE,FALSE,1471814326,1471814326,0
454740,1925,0,FALSE,FALSE,1458527307,1458527307,0
454741,1926,0,FALSE,FALSE,1474346742,1474346742,0
454746,1929,0,FALSE,FALSE,1476320956,1476320956,0
454747,1930,0,FALSE,FALSE,1468425872,1468425872,0
454748,1931,0,FALSE,FALSE,1472906398,1472906398,0
454749,1932,0,FALSE,FALSE,1458622168,1458622168,0
454750,1933,0,FALSE,FALSE,1478896231,1478896231,0
454751,1934,0,FALSE,FALSE,1454351268,1454351268,0
454753,1936,0,FALSE,FALSE,1459326909,1459326909,0
454754,1937,0,FALSE,FALSE,1470201204,1470201204,0
454755,1938,0,FALSE,FALSE,1481918432,1481918432,0
454756,1941,0,FALSE,FALSE,1473962188,1473962188,0
454757,1942,0,FALSE,FALSE,1451845852,1451845852,0
454758,1943,0,FALSE,FALSE,1450377175,1450377175,0
454759,1944,0,FALSE,FALSE,1458816332,1458816332,0
454760,1945,0,FALSE,FALSE,1471199816,1471199816,0
454762,1947,0,FALSE,FALSE,1461134865,1461134865,0
454763,1948,0,FALSE,FALSE,1461134865,1461134865,0
454764,1949,0,FALSE,FALSE,1470447072,1470447072,0
454765,1950,0,FALSE,FALSE,1470447187,1470447187,0
454766,1951,0,FALSE,FALSE,1482470878,1482470878,0
454767,1952,0,FALSE,FALSE,1478289164,1478289164,0
454768,1953,0,FALSE,FALSE,1452141416,1452141416,0
454769,1954,0,FALSE,FALSE,1474831865,1474831865,0
454772,1956,0,FALSE,FALSE,1470048264,1470048264,0
454773,1957,0,FALSE,FALSE,1463753338,1463753338,0
454774,1958,0,FALSE,FALSE,1456761385,1456761385,0
454775,1959,0,FALSE,FALSE,1482518448,1482518448,0
454776,1960,0,FALSE,FALSE,1454745477,1454745477,0
454866,1964,0,FALSE,FALSE,1459180208,1459180208,0
454883,1966,0,FALSE,FALSE,1474573004,1474573004,0
454896,1968,0,FALSE,FALSE,1449546230,1449546230,0
454897,1969,0,FALSE,FALSE,1456446490,1456446490,0
454898,1971,0,FALSE,FALSE,1458673462,1458673462,0
454899,1972,0,FALSE,FALSE,1462657813,1462657813,0
455221,1974,0,FALSE,FALSE,1472675189,1472675189,0
455222,1975,0,FALSE,FALSE,1465946558,1465946558,0
455223,1976,0,FALSE,FALSE,1480631823,1480631823,0
455224,1978,0,FALSE,FALSE,1474594872,1474594872,0
455225,1979,0,FALSE,FALSE,1479147299,1479147299,0
455227,1981,0,FALSE,FALSE,1466947596,1466947596,0
455228,1982,0,FALSE,FALSE,1474306237,1474306237,0
455232,1984,0,FALSE,FALSE,1455699481,1455699481,0
455233,1985,0,FALSE,FALSE,1455699481,1455699481,0
455234,1986,0,FALSE,FALSE,1458497587,1458497587,0
455235,1987,0,FALSE,FALSE,1463954124,1463954124,0
455238,1989,0,FALSE,FALSE,1459457664,1459457664,0
455239,1990,0,FALSE,FALSE,1472075790,1472075790,0
455240,1991,0,FALSE,FALSE,1481465163,1481465163,0
455241,1992,0,FALSE,FALSE,1469040599,1469040599,0
455242,1993,0,FALSE,FALSE,1458543843,1458543843,0
455243,1994,0,FALSE,FALSE,1458543843,1458543843,0
455244,1995,0,FALSE,FALSE,1481118478,1481118478,0
455245,1996,0,FALSE,FALSE,1468792095,1468792095,0
455246,1997,0,FALSE,FALSE,1478293066,1478293066,0
455247,1998,0,FALSE,FALSE,1471276289,1471276289,0
455248,1999,0,FALSE,FALSE,1471637039,1471637039,0
455249,2002,0,FALSE,FALSE,1457703534,1457703534,0
455256,2005,0,FALSE,FALSE,1458084162,1458084162,0
455276,2008,0,FALSE,FALSE,1460087364,1460087364,0
455277,2010,0,FALSE,FALSE,1467842249,1467842249,0
455278,2011,0,FALSE,FALSE,1472141828,1472141828,0
455279,2012,0,FALSE,FALSE,1449105497,1449105497,0
455280,2013,0,FALSE,FALSE,1462884560,1462884560,0
455281,2014,0,FALSE,FALSE,1466302636,1466302636,0
455282,2015,0,FALSE,FALSE,1483125352,1483125352,0
455303,2017,0,FALSE,FALSE,1452005877,1452005877,0
455304,2018,0,FALSE,FALSE,1460751503,1460751503,0
455305,2019,0,FALSE,FALSE,1460751503,1460751503,0
455306,2020,0,FALSE,FALSE,1482983054,1482983054,0
455307,2021,0,FALSE,FALSE,1478983871,1478983871,0
455308,2022,0,FALSE,FALSE,1479097814,1479097814,0
455311,2024,0,FALSE,FALSE,1474050696,1474050696,0
455312,2025,0,FALSE,FALSE,1464647130,1464647130,0
455313,2026,0,FALSE,FALSE,1478899463,1478899463,0
455314,2027,0,FALSE,FALSE,1470360552,1470360552,0
455315,2029,0,FALSE,FALSE,1461872011,1461872011,0
455316,2030,0,FALSE,FALSE,1474073417,1474073417,0
455317,2031,0,FALSE,FALSE,1460416744,1460416744,0
455318,2032,0,FALSE,FALSE,1480821112,1480821112,0
455407,2035,0,FALSE,FALSE,1456179671,1456179671,0
455408,2036,0,FALSE,FALSE,1450369988,1450369988,0
455410,2038,0,FALSE,FALSE,1465012324,1465012324,0
455411,2039,0,FALSE,FALSE,1451249717,1451249717,0
455412,2040,0,FALSE,FALSE,1461206664,1461206664,0
455660,2042,0,FALSE,FALSE,1457026592,1457026592,0
455661,2043,0,FALSE,FALSE,1473867284,1473867284,0
455662,2044,0,FALSE,FALSE,1467566886,1467566886,0
455663,2045,0,FALSE,FALSE,1465602459,1465602459,0
455664,2046,0,FALSE,FALSE,1457831269,1457831269,0
455683,2048,0,FALSE,FALSE,1451313629,1451313629,0
455689,2050,0,FALSE,FALSE,1465832904,1465832904,0
455690,2051,0,FALSE,FALSE,1480702194,1480702194,0
455691,2054,0,FALSE,FALSE,1465885785,1465885785,0
455692,2055,0,FALSE,FALSE,1480462255,1480462255,0
455693,2056,0,FALSE,FALSE,1480289141,1480289141,0
455694,2057,0,FALSE,FALSE,1462232756,1462232756,0
455695,2058,0,FALSE,FALSE,1478001732,1478001732,0
455696,2059,0,FALSE,FALSE,1471273134,1471273134,0
455697,2061,0,FALSE,FALSE,1450445667,1450445667,0
455698,2064,0,FALSE,FALSE,1457746043,1457746043,0
455699,2065,0,FALSE,FALSE,1461002760,1461002760,0
455700,2066,0,FALSE,FALSE,1470691835,1470691835,0
455701,2067,0,FALSE,FALSE,1470691835,1470691835,0
455702,2068,0,FALSE,FALSE,1467170414,1467170414,0
455703,2069,0,FALSE,FALSE,1478560307,1478560307,0
455704,2070,0,FALSE,FALSE,1469319776,1469319776,0
455705,2072,0,FALSE,FALSE,1476841711,1476841711,0
455706,2073,0,FALSE,FALSE,1473373984,1473373984,0
455708,2075,0,FALSE,FALSE,1452748212,1452748212,0
455709,2076,0,FALSE,FALSE,1455132130,1455132130,0
455710,2077,0,FALSE,FALSE,1457712428,1457712428,0
455711,2078,0,FALSE,FALSE,1464139833,1464139833,0
455712,2080,0,FALSE,FALSE,1467198621,1467198621,0
455713,2081,0,FALSE,FALSE,1464881671,1464881671,0
455714,2083,0,FALSE,FALSE,1473862108,1473862108,0
455715,2085,0,FALSE,FALSE,1455393636,1455393636,0
455716,2086,0,FALSE,FALSE,1462871981,1462871981,0
455730,2089,0,FALSE,FALSE,1469044422,1469044422,0
455731,2090,0,FALSE,FALSE,1468862118,1468862118,0
455735,2092,0,FALSE,FALSE,1458523560,1458523560,0
455739,2094,0,FALSE,FALSE,1463411070,1463411070,0
455740,2096,0,FALSE,FALSE,1462573748,1462573748,0
455741,2097,0,FALSE,FALSE,1466212370,1466212370,0
455746,2099,0,FALSE,FALSE,1460562628,1460562628,0
455762,2101,0,FALSE,FALSE,1482535043,1482535043,0
455763,2102,0,FALSE,FALSE,1454338869,1454338869,0
455764,2103,0,FALSE,FALSE,1454193321,1454193321,0
455765,2104,0,FALSE,FALSE,1464791756,1464791756,0
455766,2105,0,FALSE,FALSE,1459774928,1459774928,0
455767,2106,0,FALSE,FALSE,1478054623,1478054623,0
455941,2110,0,FALSE,FALSE,1460658857,1460658857,0
455942,2111,0,FALSE,FALSE,1483137103,1483137103,0
455947,2113,0,FALSE,FALSE,1470888827,1470888827,0
455948,2114,0,FALSE,FALSE,1471189797,1471189797,0
455949,2115,0,FALSE,FALSE,1452153576,1452153576,0
455950,2116,0,FALSE,FALSE,1464316816,1464316816,0
455951,2117,0,FALSE,FALSE,1471375199,1471375199,0
455952,2118,0,FALSE,FALSE,1455551712,1455551712,0
455953,2119,0,FALSE,FALSE,1454207755,1454207755,0
455954,2120,0,FALSE,FALSE,1459180206,1459180206,0
455955,2121,0,FALSE,FALSE,1469755748,1469755748,0
455956,2122,0,FALSE,FALSE,1475506014,1475506014,0
455957,2123,0,FALSE,FALSE,1479599656,1479599656,0
455958,2124,0,FALSE,FALSE,1474227419,1474227419,0
455959,2125,0,FALSE,FALSE,1467995977,1467995977,0
455960,2126,0,FALSE,FALSE,1481458117,1481458117,0
455961,2127,0,FALSE,FALSE,1477624025,1477624025,0
455962,2128,0,FALSE,FALSE,1473529955,1473529955,0
455963,2130,0,FALSE,FALSE,1472769358,1472769358,0
455964,2131,0,FALSE,FALSE,1464682345,1464682345,0
455966,2133,0,FALSE,FALSE,1451398221,1451398221,0
455967,2135,0,FALSE,FALSE,1474931963,1474931963,0
455968,2136,0,FALSE,FALSE,1454178180,1454178180,0
455969,2137,0,FALSE,FALSE,1481555377,1481555377,0
455970,2138,0,FALSE,FALSE,1456167199,1456167199,0
455972,2141,0,FALSE,FALSE,1453384855,1453384855,0
455973,2142,0,FALSE,FALSE,1462709139,1462709139,0
455974,2143,0,FALSE,FALSE,1464486403,1464486403,0
455975,2144,0,FALSE,FALSE,1453494440,1453494440,0
455976,2145,0,FALSE,FALSE,1452719077,1452719077,0
455977,2148,0,FALSE,FALSE,1463166024,1463166024,0
455978,2149,0,FALSE,FALSE,1461564368,1461564368,0
455979,2150,0,FALSE,FALSE,1469053366,1469053366,0
455980,2151,0,FALSE,FALSE,1476159789,1476159789,0
456003,2154,0,FALSE,FALSE,1469140212,1469140212,0
456004,2155,0,FALSE,FALSE,1474471370,1474471370,0
456005,2156,0,FALSE,FALSE,1451240229,1451240229,0
456006,2157,0,FALSE,FALSE,1471006804,1471006804,0
456007,2158,0,FALSE,FALSE,1478047945,1478047945,0
456008,2159,0,FALSE,FALSE,1476657394,1476657394,0
456009,2160,0,FALSE,FALSE,1463084292,1463084292,0
456010,2161,0,FALSE,FALSE,1472134564,1472134564,0
456011,2162,0,FALSE,FALSE,1449963094,1449963094,0
456012,2163,0,FALSE,FALSE,1470222341,1470222341,0
459982,2166,0,FALSE,FALSE,1451669178,1451669178,0
459983,2167,0,FALSE,FALSE,1461308686,1461308686,0
459984,2168,0,FALSE,FALSE,1469287401,1469287401,0
459985,2170,0,FALSE,FALSE,1472008227,1472008227,0
459986,2171,0,FALSE,FALSE,1456691682,1456691682,0
459987,2172,0,FALSE,FALSE,1469619438,1469619438,0
459988,2173,0,FALSE,FALSE,1468614248,1468614248,0
459989,2175,0,FALSE,FALSE,1466683990,1466683990,0
459996,2177,0,FALSE,FALSE,1470394691,1470394691,0
459997,2178,0,FALSE,FALSE,1456359235,1456359235,0
459999,2180,0,FALSE,FALSE,1452859709,1452859709,0
460000,2181,0,FALSE,FALSE,1474595504,1474595504,0
461408,2185,0,FALSE,FALSE,1471926052,1471926052,0
461412,2187,0,FALSE,FALSE,1450991966,1450991966,0
461413,2188,0,FALSE,FALSE,1471730606,1471730606,0
461414,2189,0,FALSE,FALSE,1471730606,1471730606,0
461424,2193,0,FALSE,FALSE,1461511459,1461511459,0
461429,2202,0,FALSE,FALSE,1460320876,1460320876,0
461430,2203,0,FALSE,FALSE,1460320876,1460320876,0
461437,2206,0,FALSE,FALSE,1453919235,1453919235,0
461438,2207,0,FALSE,FALSE,1474529536,1474529536,0
461439,2208,0,FALSE,FALSE,1463494068,1463494068,0
461440,2209,0,FALSE,FALSE,1471277394,1471277394,0
461441,2210,0,FALSE,FALSE,1476488509,1476488509,0
461442,2211,0,FALSE,FALSE,1463025819,1463025819,0
461443,2212,0,FALSE,FALSE,1471280673,1471280673,0
461444,2213,0,FALSE,FALSE,1482889771,1482889771,0
461445,2214,0,FALSE,FALSE,1449932839,1449932839,0
461446,2215,0,FALSE,FALSE,1472867133,1472867133,0
461447,2216,0,FALSE,FALSE,1464836006,1464836006,0
461448,2217,0,FALSE,FALSE,1463001167,1463001167,0
461449,2218,0,FALSE,FALSE,1477276113,1477276113,0
461450,2220,0,FALSE,FALSE,1476356078,1476356078,0
461451,2221,0,FALSE,FALSE,1471317846,1471317846,0
461452,2222,0,FALSE,FALSE,1482033346,1482033346,0
461453,2223,0,FALSE,FALSE,1456955414,1456955414,0
461454,2224,0,FALSE,FALSE,1482127392,1482127392,0
461455,2225,0,FALSE,FALSE,1470580020,1470580020,0
461456,2226,0,FALSE,FALSE,1460665704,1460665704,0
461457,2227,0,FALSE,FALSE,1468631191,1468631191,0
461458,2229,0,FALSE,FALSE,1474563354,1474563354,0
461459,2230,0,FALSE,FALSE,1465317744,1465317744,0
461460,2231,0,FALSE,FALSE,1455470809,1455470809,0
461461,2232,0,FALSE,FALSE,1451413748,1451413748,0
461462,2233,0,FALSE,FALSE,1465414762,1465414762,0
461463,2234,0,FALSE,FALSE,1461858667,1461858667,0
461464,2235,0,FALSE,FALSE,1478960441,1478960441,0
461497,2237,0,FALSE,FALSE,1451948653,1451948653,0
461498,2238,0,FALSE,FALSE,1453887372,1453887372,0
461499,2239,0,FALSE,FALSE,1467988481,1467988481,0
461500,2240,0,FALSE,FALSE,1474672122,1474672122,0
461501,2241,0,FALSE,FALSE,1458559018,1458559018,0
461502,2242,0,FALSE,FALSE,1472502192,1472502192,0
461503,2243,0,FALSE,FALSE,1461765854,1461765854,0
461504,2244,0,FALSE,FALSE,1468263775,1468263775,0
461505,2245,0,FALSE,FALSE,1481891254,1481891254,0
461506,2247,0,FALSE,FALSE,1456755197,1456755197,0
461508,2251,0,FALSE,FALSE,1453322517,1453322517,0
461509,2252,0,FALSE,FALSE,1450241125,1450241125,0
461510,2253,0,FALSE,FALSE,1466264608,1466264608,0
461511,2255,0,FALSE,FALSE,1449025549,1449025549,0
461512,2257,0,FALSE,FALSE,1455119699,1455119699,0
461513,2258,0,FALSE,FALSE,1456866163,1456866163,0
461514,2259,0,FALSE,FALSE,1468880825,1468880825,0
461515,2260,0,FALSE,FALSE,1473378778,1473378778,0
461516,2261,0,FALSE,FALSE,1467483210,1467483210,0
461517,2262,0,FALSE,FALSE,1478693270,1478693270,0
461518,2264,0,FALSE,FALSE,1463934170,1463934170,0
461519,2265,0,FALSE,FALSE,1450808647,1450808647,0
461520,2266,0,FALSE,FALSE,1459318382,1459318382,0
461521,2267,0,FALSE,FALSE,1459318382,1459318382,0
461522,2268,0,FALSE,FALSE,1452011077,1452011077,0
461523,2269,0,FALSE,FALSE,1465766336,1465766336,0
461524,2270,0,FALSE,FALSE,1452870069,1452870069,0
461525,2271,0,FALSE,FALSE,1462366933,1462366933,0
461526,2272,0,FALSE,FALSE,1482627543,1482627543,0
461527,2273,0,FALSE,FALSE,1468885535,1468885535,0
461532,2276,0,FALSE,FALSE,1452252542,1452252542,0
461533,2277,0,FALSE,FALSE,1472790292,1472790292,0
461534,2278,0,FALSE,FALSE,1471327058,1471327058,0
461535,2280,0,FALSE,FALSE,1472295142,1472295142,0
461536,2281,0,FALSE,FALSE,1449495350,1449495350,0
461537,2282,0,FALSE,FALSE,1450325519,1450325519,0
461538,2283,0,FALSE,FALSE,1463137670,1463137670,0
461539,2284,0,FALSE,FALSE,1477337668,1477337668,0
461540,2285,0,FALSE,FALSE,1461398673,1461398673,0
461541,2286,0,FALSE,FALSE,1465187677,1465187677,0
461585,2288,0,FALSE,FALSE,1473970033,1473970033,0
461586,2289,0,FALSE,FALSE,1472339742,1472339742,0
461588,2291,0,FALSE,FALSE,1469225510,1469225510,0
461589,2292,0,FALSE,FALSE,1469225510,1469225510,0
461590,2293,0,FALSE,FALSE,1470904773,1470904773,0
461591,2294,0,FALSE,FALSE,1464198274,1464198274,0
461594,2298,0,FALSE,FALSE,1465751111,1465751111,0
463504,2300,0,FALSE,FALSE,1479060653,1479060653,0
463505,2301,0,FALSE,FALSE,1477111842,1477111842,0
463506,2302,0,FALSE,FALSE,1451174993,1451174993,0
463510,2305,0,FALSE,FALSE,1472847532,1472847532,0
463511,2306,0,FALSE,FALSE,1452541801,1452541801,0
463512,2308,0,FALSE,FALSE,1472434825,1472434825,0
463513,2309,0,FALSE,FALSE,1458538154,1458538154,0
463514,2310,0,FALSE,FALSE,1480571864,1480571864,0
463515,2311,0,FALSE,FALSE,1453306623,1453306623,0
463516,2312,0,FALSE,FALSE,1474691236,1474691236,0
463522,2314,0,FALSE,FALSE,1452520738,1452520738,0
463523,2315,0,FALSE,FALSE,1450203396,1450203396,0
463524,2317,0,FALSE,FALSE,1480358810,1480358810,0
463525,2318,0,FALSE,FALSE,1477892303,1477892303,0
463526,2319,0,FALSE,FALSE,1482828649,1482828649,0
463527,2320,0,FALSE,FALSE,1455015304,1455015304,0
463528,2321,0,FALSE,FALSE,1471817287,1471817287,0
463529,2322,0,FALSE,FALSE,1473961562,1473961562,0
463530,2323,0,FALSE,FALSE,1470850798,1470850798,0
463531,2324,0,FALSE,FALSE,1456358952,1456358952,0
463532,2325,0,FALSE,FALSE,1455156278,1455156278,0
463534,2328,0,FALSE,FALSE,1463522832,1463522832,0
463535,2330,0,FALSE,FALSE,1480607609,1480607609,0
463536,2331,0,FALSE,FALSE,1473831585,1473831585,0
463537,2333,0,FALSE,FALSE,1459012727,1459012727,0
463538,2334,0,FALSE,FALSE,1462678877,1462678877,0
463539,2335,0,FALSE,FALSE,1452109402,1452109402,0
463541,2337,0,FALSE,FALSE,1474759995,1474759995,0
463542,2338,0,FALSE,FALSE,1474421807,1474421807,0
463543,2339,0,FALSE,FALSE,1455247053,1455247053,0
463544,2342,0,FALSE,FALSE,1463745830,1463745830,0
463545,2343,0,FALSE,FALSE,1466639320,1466639320,0
463546,2344,0,FALSE,FALSE,1461933010,1461933010,0
463547,2346,0,FALSE,FALSE,1478905031,1478905031,0
463548,2347,0,FALSE,FALSE,1477974927,1477974927,0
463549,2348,0,FALSE,FALSE,1476632557,1476632557,0
463550,2349,0,FALSE,FALSE,1461571687,1461571687,0
463551,2350,0,FALSE,FALSE,1478547804,1478547804,0
463552,2351,0,FALSE,FALSE,1456776117,1456776117,0
463554,2353,0,FALSE,FALSE,1452449508,1452449508,0
463586,2355,0,FALSE,FALSE,1452938839,1452938839,0
463587,2356,0,FALSE,FALSE,1481319605,1481319605,0
463588,2357,0,FALSE,FALSE,1477272020,1477272020,0
463589,2358,0,FALSE,FALSE,1465935318,1465935318,0
463593,2360,0,FALSE,FALSE,1469277297,1469277297,0
463595,2362,0,FALSE,FALSE,1455428546,1455428546,0
463596,2363,0,FALSE,FALSE,1455428546,1455428546,0
463597,2364,0,FALSE,FALSE,1469489588,1469489588,0
463598,2365,0,FALSE,FALSE,1459529442,1459529442,0
463599,2367,0,FALSE,FALSE,1479159740,1479159740,0
463600,2368,0,FALSE,FALSE,1481898992,1481898992,0
463601,2369,0,FALSE,FALSE,1454443917,1454443917,0
463602,2370,0,FALSE,FALSE,1451920134,1451920134,0
463603,2371,0,FALSE,FALSE,1451958309,1451958309,0
465245,2375,0,FALSE,FALSE,1451166062,1451166062,0
465246,2377,0,FALSE,FALSE,1458769346,1458769346,0
465247,2378,0,FALSE,FALSE,1459181499,1459181499,0
465281,2383,0,FALSE,FALSE,1470989001,1470989001,0
465282,2385,0,FALSE,FALSE,1461312291,1461312291,0
465283,2386,0,FALSE,FALSE,1474430600,1474430600,0
465938,2389,0,FALSE,FALSE,1466857786,1466857786,0
465939,2390,0,FALSE,FALSE,1482754311,1482754311,0
465940,2391,0,FALSE,FALSE,1470854329,1470854329,0
465941,2392,0,FALSE,FALSE,1461583735,1461583735,0
465944,2394,0,FALSE,FALSE,1455669000,1455669000,0
466748,2398,0,FALSE,FALSE,1471077832,1471077832,0
466749,2399,0,FALSE,FALSE,1471077832,1471077832,0
467153,2401,0,FALSE,FALSE,1465103766,1465103766,0
467154,2403,0,FALSE,FALSE,1459455730,1459455730,0
467155,2404,0,FALSE,FALSE,1477021514,1477021514,0
467170,2409,0,FALSE,FALSE,1463577172,1463577172,0
467171,2410,0,FALSE,FALSE,1474611486,1474611486,0
467172,2411,0,FALSE,FALSE,1471871048,1471871048,0
467173,2412,0,FALSE,FALSE,1466039837,1466039837,0
467174,2413,0,FALSE,FALSE,1460472148,1460472148,0
467175,2414,0,FALSE,FALSE,1481105957,1481105957,0
467176,2416,0,FALSE,FALSE,1454377850,1454377850,0
467177,2417,0,FALSE,FALSE,1462690972,1462690972,0
467178,2419,0,FALSE,FALSE,1473783594,1473783594,0
467179,2420,0,FALSE,FALSE,1458763663,1458763663,0
467180,2421,0,FALSE,FALSE,1480012160,1480012160,0
467181,2422,0,FALSE,FALSE,1472065646,1472065646,0
467182,2423,0,FALSE,FALSE,1463067362,1463067362,0
467183,2424,0,FALSE,FALSE,1468731491,1468731491,0
467184,2426,0,FALSE,FALSE,1458494671,1458494671,0
467185,2427,0,FALSE,FALSE,1459383728,1459383728,0
467214,2430,0,FALSE,FALSE,1459701225,1459701225,0
467215,2431,0,FALSE,FALSE,1463520618,1463520618,0
467216,2432,0,FALSE,FALSE,1474649912,1474649912,0
467217,2433,0,FALSE,FALSE,1471575578,1471575578,0
467218,2434,0,FALSE,FALSE,1470266343,1470266343,0
467232,2436,0,FALSE,FALSE,1478018630,1478018630,0
467234,2438,0,FALSE,FALSE,1467720233,1467720233,0
467235,2439,0,FALSE,FALSE,1462116258,1462116258,0
467236,2440,0,FALSE,FALSE,1470240706,1470240706,0
467237,2441,0,FALSE,FALSE,1471192983,1471192983,0
467238,2442,0,FALSE,FALSE,1452069554,1452069554,0
467239,2444,0,FALSE,FALSE,1474561583,1474561583,0
467240,2446,0,FALSE,FALSE,1452156153,1452156153,0
467241,2447,0,FALSE,FALSE,1481042637,1481042637,0
467242,2448,0,FALSE,FALSE,1471823677,1471823677,0
467329,2450,0,FALSE,FALSE,1471269850,1471269850,0
467330,2451,0,FALSE,FALSE,1469678645,1469678645,0
467331,2452,0,FALSE,FALSE,1449323202,1449323202,0
467332,2453,0,FALSE,FALSE,1451727591,1451727591,0
467333,2454,0,FALSE,FALSE,1472224812,1472224812,0
467334,2455,0,FALSE,FALSE,1452711444,1452711444,0
467335,2457,0,FALSE,FALSE,1450448395,1450448395,0
467336,2458,0,FALSE,FALSE,1463436062,1463436062,0
467337,2459,0,FALSE,FALSE,1470727484,1470727484,0
467338,2460,0,FALSE,FALSE,1466654522,1466654522,0
467339,2461,0,FALSE,FALSE,1463229193,1463229193,0
467340,2463,0,FALSE,FALSE,1454975823,1454975823,0
467341,2465,0,FALSE,FALSE,1454659720,1454659720,0
467515,2468,0,FALSE,FALSE,1454068828,1454068828,0
467516,2469,0,FALSE,FALSE,1449442321,1449442321,0
467517,2470,0,FALSE,FALSE,1467823493,1467823493,0
467518,2472,0,FALSE,FALSE,1464173831,1464173831,0
467519,2473,0,FALSE,FALSE,1463028262,1463028262,0
467520,2474,0,FALSE,FALSE,1461356183,1461356183,0
467521,2476,0,FALSE,FALSE,1463413493,1463413493,0
467522,2477,0,FALSE,FALSE,1470675122,1470675122,0
467523,2478,0,FALSE,FALSE,1482772138,1482772138,0
467524,2481,0,FALSE,FALSE,1467635352,1467635352,0
467525,2482,0,FALSE,FALSE,1454726460,1454726460,0
467526,2483,0,FALSE,FALSE,1467775153,1467775153,0
467528,2485,0,FALSE,FALSE,1468609193,1468609193,0
467529,2486,0,FALSE,FALSE,1452865502,1452865502,0
467530,2487,0,FALSE,FALSE,1452969380,1452969380,0
467531,2488,0,FALSE,FALSE,1479227755,1479227755,0
467532,2489,0,FALSE,FALSE,1476332219,1476332219,0
467537,2492,0,FALSE,FALSE,1456728371,1456728371,0
467538,2493,0,FALSE,FALSE,1456728371,1456728371,0
467539,2494,0,FALSE,FALSE,1481502915,1481502915,0
467540,2495,0,FALSE,FALSE,1457318334,1457318334,0
467541,2496,0,FALSE,FALSE,1449955903,1449955903,0
467544,2498,0,FALSE,FALSE,1474513393,1474513393,0
467545,2499,0,FALSE,FALSE,1465130370,1465130370,0
467546,2500,0,FALSE,FALSE,1458572044,1458572044,0
467547,2501,0,FALSE,FALSE,1457465805,1457465805,0
467548,2502,0,FALSE,FALSE,1473514209,1473514209,0
467549,2503,0,FALSE,FALSE,1478519091,1478519091,0
467550,2504,0,FALSE,FALSE,1456102907,1456102907,0
467551,2505,0,FALSE,FALSE,1466696045,1466696045,0
467552,2506,0,FALSE,FALSE,1457670784,1457670784,0
467590,2508,0,FALSE,FALSE,1452896007,1452896007,0
467591,2509,0,FALSE,FALSE,1453915867,1453915867,0
467592,2510,0,FALSE,FALSE,1477311890,1477311890,0
467593,2511,0,FALSE,FALSE,1456116867,1456116867,0
467594,2512,0,FALSE,FALSE,1453120706,1453120706,0
467595,2513,0,FALSE,FALSE,1459803372,1459803372,0
467596,2514,0,FALSE,FALSE,1455308738,1455308738,0
467597,2515,0,FALSE,FALSE,1474289106,1474289106,0
467598,2516,0,FALSE,FALSE,1468672850,1468672850,0
467599,2517,0,FALSE,FALSE,1474342026,1474342026,0
467653,2521,0,FALSE,FALSE,1469800192,1469800192,0
467654,2522,0,FALSE,FALSE,1458416031,1458416031,0
467655,2523,0,FALSE,FALSE,1468440357,1468440357,0
467657,2525,0,FALSE,FALSE,1453040554,1453040554,0
467658,2526,0,FALSE,FALSE,1471110040,1471110040,0
467659,2527,0,FALSE,FALSE,1457217712,1457217712,0
467660,2528,0,FALSE,FALSE,1465530870,1465530870,0
467661,2529,0,FALSE,FALSE,1466730278,1466730278,0
467662,2530,0,FALSE,FALSE,1450979849,1450979849,0
467663,2531,0,FALSE,FALSE,1469647292,1469647292,0
467664,2532,0,FALSE,FALSE,1455888258,1455888258,0
467665,2533,0,FALSE,FALSE,1459427226,1459427226,0
467666,2534,0,FALSE,FALSE,1482066042,1482066042,0
467667,2535,0,FALSE,FALSE,1473173708,1473173708,0
467668,2537,0,FALSE,FALSE,1466073858,1466073858,0
467669,2538,0,FALSE,FALSE,1482828249,1482828249,0
467670,2540,0,FALSE,FALSE,1472073838,1472073838,0
467706,2543,0,FALSE,FALSE,1461765269,1461765269,0
468042,2548,0,FALSE,FALSE,1466105162,1466105162,0
468043,2550,0,FALSE,FALSE,1458968116,1458968116,0
468044,2551,0,FALSE,FALSE,1451374640,1451374640,0
468045,2552,0,FALSE,FALSE,1455905154,1455905154,0
468046,2553,0,FALSE,FALSE,1477188843,1477188843,0
468047,2554,0,FALSE,FALSE,1474259521,1474259521,0
468048,2555,0,FALSE,FALSE,1466474988,1466474988,0
468049,2556,0,FALSE,FALSE,1458834023,1458834023,0
468050,2557,0,FALSE,FALSE,1460057524,1460057524,0
468051,2558,0,FALSE,FALSE,1458940839,1458940839,0
468052,2559,0,FALSE,FALSE,1463902954,1463902954,0
468053,2561,0,FALSE,FALSE,1469812198,1469812198,0
468054,2562,0,FALSE,FALSE,1464372213,1464372213,0
468055,2563,0,FALSE,FALSE,1467785193,1467785193,0
468056,2564,0,FALSE,FALSE,1479169501,1479169501,0
468070,2568,0,FALSE,FALSE,1478926582,1478926582,0
468071,2569,0,FALSE,FALSE,1462124545,1462124545,0
468072,2570,0,FALSE,FALSE,1482125981,1482125981,0
468073,2571,0,FALSE,FALSE,1453046180,1453046180,0
468074,2572,0,FALSE,FALSE,1475194831,1475194831,0
468075,2573,0,FALSE,FALSE,1472645103,1472645103,0
468076,2576,0,FALSE,FALSE,1464703324,1464703324,0
468077,2577,0,FALSE,FALSE,1450320971,1450320971,0
468078,2578,0,FALSE,FALSE,1449309368,1449309368,0
468079,2579,0,FALSE,FALSE,1459972105,1459972105,0
468080,2580,0,FALSE,FALSE,1451578985,1451578985,0
468081,2582,0,FALSE,FALSE,1464600182,1464600182,0
468082,2583,0,FALSE,FALSE,1458833197,1458833197,0
468131,2586,0,FALSE,FALSE,1467196544,1467196544,0
468132,2587,0,FALSE,FALSE,1452025086,1452025086,0
468133,2588,0,FALSE,FALSE,1467914022,1467914022,0
468170,2591,0,FALSE,FALSE,1449526605,1449526605,0
468171,2592,0,FALSE,FALSE,1461830207,1461830207,0
468172,2593,0,FALSE,FALSE,1467634771,1467634771,0
468173,2594,0,FALSE,FALSE,1468608435,1468608435,0
468174,2595,0,FALSE,FALSE,1455316859,1455316859,0
468175,2596,0,FALSE,FALSE,1460003043,1460003043,0
468176,2597,0,FALSE,FALSE,1477524761,1477524761,0
468177,2598,0,FALSE,FALSE,1450120931,1450120931,0
468188,2601,0,FALSE,FALSE,1463179165,1463179165,0
468189,2602,0,FALSE,FALSE,1467607241,1467607241,0
468234,2604,0,FALSE,FALSE,1470614673,1470614673,0
468235,2605,0,FALSE,FALSE,1452827866,1452827866,0
468236,2606,0,FALSE,FALSE,1467959194,1467959194,0
468237,2607,0,FALSE,FALSE,1453934801,1453934801,0
468238,2608,0,FALSE,FALSE,1467045582,1467045582,0
468239,2609,0,FALSE,FALSE,1463395128,1463395128,0
468240,2611,0,FALSE,FALSE,1461267492,1461267492,0
468378,2615,0,FALSE,FALSE,1478121287,1478121287,0
468379,2616,0,FALSE,FALSE,1482961997,1482961997,0
468380,2617,0,FALSE,FALSE,1457284725,1457284725,0
468381,2618,0,FALSE,FALSE,1465199004,1465199004,0
468383,2620,0,FALSE,FALSE,1451682805,1451682805,0
468384,2621,0,FALSE,FALSE,1462552049,1462552049,0
468385,2622,0,FALSE,FALSE,1453736410,1453736410,0
468386,2624,0,FALSE,FALSE,1478268479,1478268479,0
468387,2625,0,FALSE,FALSE,1461539087,1461539087,0
468388,2626,0,FALSE,FALSE,1454206616,1454206616,0
468389,2627,0,FALSE,FALSE,1458907233,1458907233,0
468390,2628,0,FALSE,FALSE,1450209655,1450209655,0
468391,2629,0,FALSE,FALSE,1453646203,1453646203,0
468394,2631,0,FALSE,FALSE,1453110546,1453110546,0
468395,2632,0,FALSE,FALSE,1451642216,1451642216,0
468396,2633,0,FALSE,FALSE,1472492514,1472492514,0
468397,2634,0,FALSE,FALSE,1470394860,1470394860,0
468398,2635,0,FALSE,FALSE,1457882193,1457882193,0
468399,2636,0,FALSE,FALSE,1460819333,1460819333,0
468400,2638,0,FALSE,FALSE,1474481032,1474481032,0
468401,2640,0,FALSE,FALSE,1454458513,1454458513,0
468402,2642,0,FALSE,FALSE,1463047739,1463047739,0
468403,2644,0,FALSE,FALSE,1476664507,1476664507,0
468407,2646,0,FALSE,FALSE,1472668101,1472668101,0
468411,2648,0,FALSE,FALSE,1459174909,1459174909,0
468412,2649,0,FALSE,FALSE,1472430614,1472430614,0
468413,2650,0,FALSE,FALSE,1458171025,1458171025,0
468414,2651,0,FALSE,FALSE,1468309654,1468309654,0
468415,2652,0,FALSE,FALSE,1461458868,1461458868,0
468416,2653,0,FALSE,FALSE,1454850634,1454850634,0
468417,2654,0,FALSE,FALSE,1469132596,1469132596,0
468418,2655,0,FALSE,FALSE,1472490790,1472490790,0
468419,2657,0,FALSE,FALSE,1452876784,1452876784,0
468420,2658,0,FALSE,FALSE,1453754011,1453754011,0
468421,2659,0,FALSE,FALSE,1454414972,1454414972,0
468423,2661,0,FALSE,FALSE,1465412972,1465412972,0
468424,2662,0,FALSE,FALSE,1480315252,1480315252,0
468425,2664,0,FALSE,FALSE,1476715145,1476715145,0
468426,2665,0,FALSE,FALSE,1477687193,1477687193,0
468427,2666,0,FALSE,FALSE,1473723264,1473723264,0
468428,2667,0,FALSE,FALSE,1452771602,1452771602,0
468429,2668,0,FALSE,FALSE,1453568008,1453568008,0
468430,2669,0,FALSE,FALSE,1469066405,1469066405,0
468431,2670,0,FALSE,FALSE,1462374790,1462374790,0
468432,2671,0,FALSE,FALSE,1464265553,1464265553,0
468433,2672,0,FALSE,FALSE,1473724647,1473724647,0
468434,2673,0,FALSE,FALSE,1461104350,1461104350,0
468435,2674,0,FALSE,FALSE,1458638859,1458638859,0
468436,2675,0,FALSE,FALSE,1465880859,1465880859,0
468443,2677,0,FALSE,FALSE,1465319435,1465319435,0
468444,2679,0,FALSE,FALSE,1464904742,1464904742,0
495609,2681,0,FALSE,FALSE,1462464792,1462464792,0
495610,2682,0,FALSE,FALSE,1474590789,1474590789,0
495611,2684,0,FALSE,FALSE,1456539385,1456539385,0
495714,2686,0,FALSE,FALSE,1452750473,1452750473,0
495715,2687,0,FALSE,FALSE,1460958798,1460958798,0
495716,2688,0,FALSE,FALSE,1469967483,1469967483,0
495717,2691,0,FALSE,FALSE,1465541489,1465541489,0
495742,2693,0,FALSE,FALSE,1469765676,1469765676,0
495746,2695,0,FALSE,FALSE,1466194325,1466194325,0
495747,2696,0,FALSE,FALSE,1449556256,1449556256,0
495748,2697,0,FALSE,FALSE,1467911810,1467911810,0
495749,2698,0,FALSE,FALSE,1460663037,1460663037,0
495750,2699,0,FALSE,FALSE,1451582148,1451582148,0
495751,2700,0,FALSE,FALSE,1475362283,1475362283,0
495752,2701,0,FALSE,FALSE,1475259860,1475259860,0
495753,2702,0,FALSE,FALSE,1462814770,1462814770,0
495754,2703,0,FALSE,FALSE,1478463243,1478463243,0
495763,2706,0,FALSE,FALSE,1451321176,1451321176,0
495764,2707,0,FALSE,FALSE,1481989333,1481989333,0
495765,2709,0,FALSE,FALSE,1451316712,1451316712,0
495766,2710,0,FALSE,FALSE,1472318176,1472318176,0
495771,2713,0,FALSE,FALSE,1461961693,1461961693,0
495772,2714,0,FALSE,FALSE,1464626349,1464626349,0
495773,2717,0,FALSE,FALSE,1459769721,1459769721,0
495774,2718,0,FALSE,FALSE,1464275916,1464275916,0
495775,2719,0,FALSE,FALSE,1461393077,1461393077,0
495778,2721,0,FALSE,FALSE,1474261801,1474261801,0
495779,2722,0,FALSE,FALSE,1457098227,1457098227,0
495780,2723,0,FALSE,FALSE,1450805262,1450805262,0
495787,2725,0,FALSE,FALSE,1454948256,1454948256,0
495788,2726,0,FALSE,FALSE,1476915000,1476915000,0
495789,2727,0,FALSE,FALSE,1466017274,1466017274,0
495790,2728,0,FALSE,FALSE,1472400518,1472400518,0
495791,2729,0,FALSE,FALSE,1464081029,1464081029,0
495792,2730,0,FALSE,FALSE,1474270477,1474270477,0
495818,2733,0,FALSE,FALSE,1469180706,1469180706,0
495819,2735,0,FALSE,FALSE,1454009678,1454009678,0
496582,2737,0,FALSE,FALSE,1461856703,1461856703,0
496583,2738,0,FALSE,FALSE,1462020398,1462020398,0
496584,2739,0,FALSE,FALSE,1469120514,1469120514,0
496585,2740,0,FALSE,FALSE,1478650425,1478650425,0
496586,2741,0,FALSE,FALSE,1472323769,1472323769,0
496587,2742,0,FALSE,FALSE,1465686557,1465686557,0
496588,2743,0,FALSE,FALSE,1469928497,1469928497,0
496589,2744,0,FALSE,FALSE,1479540571,1479540571,0
496590,2745,0,FALSE,FALSE,1466526377,1466526377,0
496591,2746,0,FALSE,FALSE,1475592075,1475592075,0
496592,2747,0,FALSE,FALSE,1475291460,1475291460,0
496593,2748,0,FALSE,FALSE,1470813559,1470813559,0
496648,2750,0,FALSE,FALSE,1455896204,1455896204,0
496649,2751,0,FALSE,FALSE,1478481422,1478481422,0
496650,2752,0,FALSE,FALSE,1481744490,1481744490,0
496651,2753,0,FALSE,FALSE,1477770996,1477770996,0
496652,2754,0,FALSE,FALSE,1457439505,1457439505,0
496653,2755,0,FALSE,FALSE,1476630767,1476630767,0
496657,2757,0,FALSE,FALSE,1482114202,1482114202,0
496658,2758,0,FALSE,FALSE,1459631172,1459631172,0
496659,2759,0,FALSE,FALSE,1467076049,1467076049,0
496671,2763,0,FALSE,FALSE,1461331931,1461331931,0
496672,2764,0,FALSE,FALSE,1467314180,1467314180,0
496673,2765,0,FALSE,FALSE,1481425465,1481425465,0
496674,2766,0,FALSE,FALSE,1450898588,1450898588,0
496675,2767,0,FALSE,FALSE,1472927319,1472927319,0
496676,2768,0,FALSE,FALSE,1451676862,1451676862,0
496677,2769,0,FALSE,FALSE,1481054550,1481054550,0
496688,2771,0,FALSE,FALSE,1474205235,1474205235,0
496689,2772,0,FALSE,FALSE,1465606332,1465606332,0
496690,2773,0,FALSE,FALSE,1455646604,1455646604,0
496691,2774,0,FALSE,FALSE,1470587027,1470587027,0
496692,2775,0,FALSE,FALSE,1449784771,1449784771,0
496708,2780,0,FALSE,FALSE,1467974116,1467974116,0
496709,2781,0,FALSE,FALSE,1455579240,1455579240,0
496710,2782,0,FALSE,FALSE,1458102194,1458102194,0
496712,2784,0,FALSE,FALSE,1461648408,1461648408,0
496713,2786,0,FALSE,FALSE,1455899051,1455899051,0
496714,2787,0,FALSE,FALSE,1479220928,1479220928,0
496715,2788,0,FALSE,FALSE,1461172751,1461172751,0
496716,2789,0,FALSE,FALSE,1473267996,1473267996,0
496717,2792,0,FALSE,FALSE,1466456052,1466456052,0
496718,2793,0,FALSE,FALSE,1449549719,1449549719,0
496719,2794,0,FALSE,FALSE,1476517719,1476517719,0
496731,2796,0,FALSE,FALSE,1461792215,1461792215,0
496732,2797,0,FALSE,FALSE,1450556808,1450556808,0
496733,2798,0,FALSE,FALSE,1475268495,1475268495,0
496734,2799,0,FALSE,FALSE,1455745178,1455745178,0
496736,2801,0,FALSE,FALSE,1483113217,1483113217,0
497656,2804,0,FALSE,FALSE,1474491281,1474491281,0
497657,2805,0,FALSE,FALSE,1478435900,1478435900,0
497658,2807,0,FALSE,FALSE,1482465379,1482465379,0
497676,2811,0,FALSE,FALSE,1474309746,1474309746,0
497677,2812,0,FALSE,FALSE,1463398700,1463398700,0
497678,2815,0,FALSE,FALSE,1455559081,1455559081,0
498150,2819,0,FALSE,FALSE,1469466183,1469466183,0
498151,2820,0,FALSE,FALSE,1452122547,1452122547,0
498152,2821,0,FALSE,FALSE,1483048157,1483048157,0
498153,2823,0,FALSE,FALSE,1449692571,1449692571,0
498154,2824,0,FALSE,FALSE,1457022729,1457022729,0
498158,2828,0,FALSE,FALSE,1465329207,1465329207,0
498213,2830,0,FALSE,FALSE,1454133969,1454133969,0
498214,2831,0,FALSE,FALSE,1458668696,1458668696,0
498215,2832,0,FALSE,FALSE,1457272778,1457272778,0
498216,2834,0,FALSE,FALSE,1454522520,1454522520,0
498217,2835,0,FALSE,FALSE,1456622518,1456622518,0
498229,2837,0,FALSE,FALSE,1450356286,1450356286,0
498230,2838,0,FALSE,FALSE,1465492677,1465492677,0
498231,2839,0,FALSE,FALSE,1457526830,1457526830,0
498233,2841,0,FALSE,FALSE,1449736022,1449736022,0
498234,2842,0,FALSE,FALSE,1472332748,1472332748,0
498242,2844,0,FALSE,FALSE,1472050720,1472050720,0
498243,2845,0,FALSE,FALSE,1469211804,1469211804,0
498244,2846,0,FALSE,FALSE,1472715583,1472715583,0
498245,2847,0,FALSE,FALSE,1452841755,1452841755,0
498246,2848,0,FALSE,FALSE,1455003284,1455003284,0
498247,2849,0,FALSE,FALSE,1454374254,1454374254,0
498248,2850,0,FALSE,FALSE,1471295460,1471295460,0
498262,2854,0,FALSE,FALSE,1460940938,1460940938,0
498263,2855,0,FALSE,FALSE,1467159151,1467159151,0
498264,2856,0,FALSE,FALSE,1463268626,1463268626,0
498265,2857,0,FALSE,FALSE,1464820619,1464820619,0
498266,2858,0,FALSE,FALSE,1451157046,1451157046,0
498267,2859,0,FALSE,FALSE,1456078668,1456078668,0
498268,2860,0,FALSE,FALSE,1479915917,1479915917,0
498269,2861,0,FALSE,FALSE,1449001733,1449001733,0
498270,2862,0,FALSE,FALSE,1470523269,1470523269,0
498271,2863,0,FALSE,FALSE,1475354741,1475354741,0
498291,2865,0,FALSE,FALSE,1452245993,1452245993,0
498296,2867,0,FALSE,FALSE,1478701429,1478701429,0
498297,2869,0,FALSE,FALSE,1454718633,1454718633,0
498298,2870,0,FALSE,FALSE,1469113993,1469113993,0
498299,2871,0,FALSE,FALSE,1470592948,1470592948,0
498300,2872,0,FALSE,FALSE,1466774041,1466774041,0
498301,2875,0,FALSE,FALSE,1473382262,1473382262,0
498302,2876,0,FALSE,FALSE,1479669348,1479669348,0
498471,2881,0,FALSE,FALSE,1451520846,1451520846,0
498475,2883,0,FALSE,FALSE,1460387986,1460387986,0
498482,2886,0,FALSE,FALSE,1450277091,1450277091,0
498485,2888,0,FALSE,FALSE,1482881524,1482881524,0
498486,2890,0,FALSE,FALSE,1475503400,1475503400,0
498487,2891,0,FALSE,FALSE,1453140914,1453140914,0
498488,2892,0,FALSE,FALSE,1465418137,1465418137,0
498489,2893,0,FALSE,FALSE,1463269346,1463269346,0
498490,2894,0,FALSE,FALSE,1475012573,1475012573,0
498491,2895,0,FALSE,FALSE,1455633012,1455633012,0
498494,2898,0,FALSE,FALSE,1465071683,1465071683,0
498495,2900,0,FALSE,FALSE,1462452171,1462452171,0
498496,2901,0,FALSE,FALSE,1474295818,1474295818,0
498497,2902,0,FALSE,FALSE,1467077800,1467077800,0
498498,2903,0,FALSE,FALSE,1467642218,1467642218,0
498499,2904,0,FALSE,FALSE,1460336708,1460336708,0
498500,2905,0,FALSE,FALSE,1477685610,1477685610,0
498642,2908,0,FALSE,FALSE,1462143352,1462143352,0
498643,2909,0,FALSE,FALSE,1456156652,1456156652,0
498644,2910,0,FALSE,FALSE,1478099776,1478099776,0
498645,2911,0,FALSE,FALSE,1482762018,1482762018,0
498680,2915,0,FALSE,FALSE,1453233815,1453233815,0
498703,2922,0,FALSE,FALSE,1452523139,1452523139,0
498765,2931,0,FALSE,FALSE,1452375311,1452375311,0
498766,2932,0,FALSE,FALSE,1461638638,1461638638,0
499523,2936,0,FALSE,FALSE,1472260631,1472260631,0
499524,2937,0,FALSE,FALSE,1479686231,1479686231,0
499525,2938,0,FALSE,FALSE,1463010760,1463010760,0
499528,2941,0,FALSE,FALSE,1462906821,1462906821,0
499530,2943,0,FALSE,FALSE,1454162859,1454162859,0
499927,2945,0,FALSE,FALSE,1450783486,1450783486,0
499928,2946,0,FALSE,FALSE,1481265284,1481265284,0
499929,2947,0,FALSE,FALSE,1482477914,1482477914,0
499930,2948,0,FALSE,FALSE,1479139146,1479139146,0
499931,2949,0,FALSE,FALSE,1468889845,1468889845,0
499932,2950,0,FALSE,FALSE,1471311083,1471311083,0
499933,2951,0,FALSE,FALSE,1460302807,1460302807,0
499934,2952,0,FALSE,FALSE,1454955130,1454955130,0
499935,2953,0,FALSE,FALSE,1455483734,1455483734,0
499936,2954,0,FALSE,FALSE,1463872049,1463872049,0
499952,2957,0,FALSE,FALSE,1465330812,1465330812,0
499953,2959,0,FALSE,FALSE,1480921162,1480921162,0
499954,2960,0,FALSE,FALSE,1471305489,1471305489,0
499955,2961,0,FALSE,FALSE,1455475983,1455475983,0
500011,2964,0,FALSE,FALSE,1474958762,1474958762,0
500049,2967,0,FALSE,FALSE,1465496918,1465496918,0
500050,2968,0,FALSE,FALSE,1480691480,1480691480,0
500051,2969,0,FALSE,FALSE,1463582051,1463582051,0
500133,2972,0,FALSE,FALSE,1455888461,1455888461,0
500197,2974,0,FALSE,FALSE,1478622932,1478622932,0
500198,2975,0,FALSE,FALSE,1472231803,1472231803,0
500199,2976,0,FALSE,FALSE,1476206474,1476206474,0
500200,2977,0,FALSE,FALSE,1451298704,1451298704,0
500201,2978,0,FALSE,FALSE,1471285361,1471285361,0
500203,2980,0,FALSE,FALSE,1462638687,1462638687,0
500204,2982,0,FALSE,FALSE,1456174144,1456174144,0
500205,2983,0,FALSE,FALSE,1461960837,1461960837,0
500206,2984,0,FALSE,FALSE,1476213434,1476213434,0
500211,2986,0,FALSE,FALSE,1453477104,1453477104,0
500212,2987,0,FALSE,FALSE,1468797372,1468797372,0
500213,2988,0,FALSE,FALSE,1449246018,1449246018,0
500276,2990,0,FALSE,FALSE,1466078780,1466078780,0
500277,2991,0,FALSE,FALSE,1474767725,1474767725,0
500278,2992,0,FALSE,FALSE,1456888309,1456888309,0
500284,2994,0,FALSE,FALSE,1469805473,1469805473,0
500285,2997,0,FALSE,FALSE,1455113465,1455113465,0
500286,2999,0,FALSE,FALSE,1451470831,1451470831,0
500287,3000,0,FALSE,FALSE,1463126582,1463126582,0
500288,3001,0,FALSE,FALSE,1478092391,1478092391,0
500289,3002,0,FALSE,FALSE,1473883792,1473883792,0
500293,3004,0,FALSE,FALSE,1474726221,1474726221,0
500294,3005,0,FALSE,FALSE,1468952539,1468952539,0
500295,3008,0,FALSE,FALSE,1471036820,1471036820,0
500296,3009,0,FALSE,FALSE,1471036820,1471036820,0
500301,3012,0,FALSE,FALSE,1452030277,1452030277,0
500302,3014,0,FALSE,FALSE,1479673815,1479673815,0
500303,3015,0,FALSE,FALSE,1456580774,1456580774,0
500304,3017,0,FALSE,FALSE,1451493698,1451493698,0
500327,3020,0,FALSE,FALSE,1471101735,1471101735,0
500328,3021,0,FALSE,FALSE,1477087010,1477087010,0
500329,3022,0,FALSE,FALSE,1472305464,1472305464,0
500330,3023,0,FALSE,FALSE,1453288342,1453288342,0
500331,3024,0,FALSE,FALSE,1454201827,1454201827,0
500332,3025,0,FALSE,FALSE,1453230197,1453230197,0
500333,3027,0,FALSE,FALSE,1461182609,1461182609,0
500334,3028,0,FALSE,FALSE,1462236775,1462236775,0
500336,3031,0,FALSE,FALSE,1468738821,1468738821,0
502080,3033,0,FALSE,FALSE,1459198916,1459198916,0
502081,3035,0,FALSE,FALSE,1454074689,1454074689,0
502082,3038,0,FALSE,FALSE,1472228001,1472228001,0
502095,3040,0,FALSE,FALSE,1463331289,1463331289,0
502096,3041,0,FALSE,FALSE,1464991217,1464991217,0
502097,3042,0,FALSE,FALSE,1459155324,1459155324,0
502098,3043,0,FALSE,FALSE,1470155898,1470155898,0
502099,3044,0,FALSE,FALSE,1464904329,1464904329,0
502100,3045,0,FALSE,FALSE,1473331748,1473331748,0
502153,3047,0,FALSE,FALSE,1451231754,1451231754,0
502154,3048,0,FALSE,FALSE,1463661270,1463661270,0
502253,3051,0,FALSE,FALSE,1455227918,1455227918,0
502254,3052,0,FALSE,FALSE,1478453796,1478453796,0
502255,3053,0,FALSE,FALSE,1472307532,1472307532,0
502256,3054,0,FALSE,FALSE,1457467328,1457467328,0
502257,3055,0,FALSE,FALSE,1478735252,1478735252,0
502258,3056,0,FALSE,FALSE,1467248444,1467248444,0
502259,3057,0,FALSE,FALSE,1473529839,1473529839,0
502260,3058,0,FALSE,FALSE,1466667108,1466667108,0
502469,3061,0,FALSE,FALSE,1480976581,1480976581,0
502470,3062,0,FALSE,FALSE,1457225433,1457225433,0
502471,3063,0,FALSE,FALSE,1463725692,1463725692,0
502472,3064,0,FALSE,FALSE,1457113675,1457113675,0
502478,3066,0,FALSE,FALSE,1464327583,1464327583,0
502479,3067,0,FALSE,FALSE,1476886530,1476886530,0
502480,3068,0,FALSE,FALSE,1451496147,1451496147,0
502483,3070,0,FALSE,FALSE,1473474896,1473474896,0
502484,3071,0,FALSE,FALSE,1473662079,1473662079,0
502485,3072,0,FALSE,FALSE,1458172390,1458172390,0
502486,3073,0,FALSE,FALSE,1482056143,1482056143,0
502487,3074,0,FALSE,FALSE,1455997576,1455997576,0
502488,3075,0,FALSE,FALSE,1461537350,1461537350,0
502489,3077,0,FALSE,FALSE,1456711017,1456711017,0
502490,3078,0,FALSE,FALSE,1483118175,1483118175,0
502509,3081,0,FALSE,FALSE,1470599702,1470599702,0
502510,3083,0,FALSE,FALSE,1457699991,1457699991,0
502511,3084,0,FALSE,FALSE,1481719969,1481719969,0
502512,3085,0,FALSE,FALSE,1480944252,1480944252,0
502513,3086,0,FALSE,FALSE,1452197414,1452197414,0
502514,3087,0,FALSE,FALSE,1474179244,1474179244,0
502517,3089,0,FALSE,FALSE,1470068402,1470068402,0
502519,3091,0,FALSE,FALSE,1456079881,1456079881,0
502520,3093,0,FALSE,FALSE,1478704815,1478704815,0
502521,3094,0,FALSE,FALSE,1462383199,1462383199,0
502522,3095,0,FALSE,FALSE,1460502437,1460502437,0
502523,3096,0,FALSE,FALSE,1468167028,1468167028,0
502524,3097,0,FALSE,FALSE,1456788082,1456788082,0
502525,3098,0,FALSE,FALSE,1460421752,1460421752,0
502526,3099,0,FALSE,FALSE,1456328835,1456328835,0
502527,3100,0,FALSE,FALSE,1461522188,1461522188,0
502531,3103,0,FALSE,FALSE,1451226552,1451226552,0
502532,3104,0,FALSE,FALSE,1454529863,1454529863,0
502533,3105,0,FALSE,FALSE,1474358184,1474358184,0
503245,3108,0,FALSE,FALSE,1465312243,1465312243,0
503246,3109,0,FALSE,FALSE,1469570330,1469570330,0
503247,3110,0,FALSE,FALSE,1450335025,1450335025,0
503248,3111,0,FALSE,FALSE,1464705221,1464705221,0
503251,3114,0,FALSE,FALSE,1475468778,1475468778,0
503252,3115,0,FALSE,FALSE,1474138545,1474138545,0
503356,3117,0,FALSE,FALSE,1465155277,1465155277,0
503357,3118,0,FALSE,FALSE,1460130418,1460130418,0
503358,3119,0,FALSE,FALSE,1460642702,1460642702,0
503359,3120,0,FALSE,FALSE,1467082743,1467082743,0
503360,3121,0,FALSE,FALSE,1454441948,1454441948,0
503361,3123,0,FALSE,FALSE,1453168928,1453168928,0
503362,3124,0,FALSE,FALSE,1453440312,1453440312,0
503363,3125,0,FALSE,FALSE,1470116528,1470116528,0
503364,3126,0,FALSE,FALSE,1473432058,1473432058,0
503365,3127,0,FALSE,FALSE,1456489413,1456489413,0
503366,3128,0,FALSE,FALSE,1469232533,1469232533,0
503367,3129,0,FALSE,FALSE,1458075316,1458075316,0
503368,3130,0,FALSE,FALSE,1452782554,1452782554,0
503369,3131,0,FALSE,FALSE,1471734393,1471734393,0
503370,3132,0,FALSE,FALSE,1473565902,1473565902,0
503372,3134,0,FALSE,FALSE,1481419174,1481419174,0
503373,3135,0,FALSE,FALSE,1467546908,1467546908,0
503374,3138,0,FALSE,FALSE,1464944044,1464944044,0
503375,3139,0,FALSE,FALSE,1456948014,1456948014,0
503411,3141,0,FALSE,FALSE,1475697403,1475697403,0
503412,3144,0,FALSE,FALSE,1466435969,1466435969,0
503413,3146,0,FALSE,FALSE,1459426419,1459426419,0
503414,3147,0,FALSE,FALSE,1449108544,1449108544,0
503415,3148,0,FALSE,FALSE,1455145385,1455145385,0
503416,3149,0,FALSE,FALSE,1461546454,1461546454,0
503417,3150,0,FALSE,FALSE,1464515810,1464515810,0
503422,3153,0,FALSE,FALSE,1482769123,1482769123,0
517320,3156,0,FALSE,FALSE,1476663035,1476663035,0
517551,3158,0,FALSE,FALSE,1449520104,1449520104,0
517552,3159,0,FALSE,FALSE,1470812454,1470812454,0
517553,3160,0,FALSE,FALSE,1453179328,1453179328,0
517554,3162,0,FALSE,FALSE,1470861183,1470861183,0
518935,3165,0,FALSE,FALSE,1470785092,1470785092,0
519942,3168,0,FALSE,FALSE,1469807244,1469807244,0
519943,3170,0,FALSE,FALSE,1476130763,1476130763,0
519944,3171,0,FALSE,FALSE,1451576936,1451576936,0
519945,3173,0,FALSE,FALSE,1457403684,1457403684,0
519952,3177,0,FALSE,FALSE,1451175117,1451175117,0
520009,3179,0,FALSE,FALSE,1450307459,1450307459,0
520730,3183,0,FALSE,FALSE,1470595422,1470595422,0
520731,3184,0,FALSE,FALSE,1456622912,1456622912,0
520732,3185,0,FALSE,FALSE,1466743370,1466743370,0
520733,3186,0,FALSE,FALSE,1458156722,1458156722,0
520734,3187,0,FALSE,FALSE,1466041602,1466041602,0
520735,3188,0,FALSE,FALSE,1466175001,1466175001,0
520736,3190,0,FALSE,FALSE,1474502324,1474502324,0
520737,3191,0,FALSE,FALSE,1451632766,1451632766,0
520740,3193,0,FALSE,FALSE,1469028672,1469028672,0
520741,3194,0,FALSE,FALSE,1468948214,1468948214,0
520742,3195,0,FALSE,FALSE,1464739917,1464739917,0
520761,3197,0,FALSE,FALSE,1457738465,1457738465,0
520762,3198,0,FALSE,FALSE,1468087447,1468087447,0
520763,3199,0,FALSE,FALSE,1478965045,1478965045,0
520764,3200,0,FALSE,FALSE,1452893536,1452893536,0
520765,3201,0,FALSE,FALSE,1460906315,1460906315,0
520766,3202,0,FALSE,FALSE,1459713769,1459713769,0
520767,3203,0,FALSE,FALSE,1457922261,1457922261,0
520768,3204,0,FALSE,FALSE,1473281072,1473281072,0
520769,3205,0,FALSE,FALSE,1460563376,1460563376,0
520770,3206,0,FALSE,FALSE,1461447925,1461447925,0
520774,3208,0,FALSE,FALSE,1465524132,1465524132,0
520778,3211,0,FALSE,FALSE,1476495276,1476495276,0
520830,3215,0,FALSE,FALSE,1462146134,1462146134,0
520832,3217,0,FALSE,FALSE,1478356530,1478356530,0
520834,3219,0,FALSE,FALSE,1457462771,1457462771,0
520835,3220,0,FALSE,FALSE,1454978007,1454978007,0
520836,3221,0,FALSE,FALSE,1475205143,1475205143,0
520837,3222,0,FALSE,FALSE,1482446130,1482446130,0
520838,3223,0,FALSE,FALSE,1451543539,1451543539,0
520839,3224,0,FALSE,FALSE,1457471235,1457471235,0
520894,3228,0,FALSE,FALSE,1479154683,1479154683,0
520895,3229,0,FALSE,FALSE,1471903588,1471903588,0
520896,3230,0,FALSE,FALSE,1471903588,1471903588,0
520897,3231,0,FALSE,FALSE,1464871995,1464871995,0
520898,3232,0,FALSE,FALSE,1452643379,1452643379,0
520899,3233,0,FALSE,FALSE,1472570640,1472570640,0
520900,3234,0,FALSE,FALSE,1479014179,1479014179,0
520901,3236,0,FALSE,FALSE,1451578039,1451578039,0
520902,3237,0,FALSE,FALSE,1476575129,1476575129,0
520903,3238,0,FALSE,FALSE,1482859366,1482859366,0
521042,3240,0,FALSE,FALSE,1471671458,1471671458,0
521043,3241,0,FALSE,FALSE,1467943382,1467943382,0
521044,3242,0,FALSE,FALSE,1461264499,1461264499,0
521045,3243,0,FALSE,FALSE,1456337811,1456337811,0
521046,3244,0,FALSE,FALSE,1452151501,1452151501,0
521047,3245,0,FALSE,FALSE,1461185384,1461185384,0
521048,3246,0,FALSE,FALSE,1456445650,1456445650,0
521049,3248,0,FALSE,FALSE,1467730632,1467730632,0
521050,3249,0,FALSE,FALSE,1476185613,1476185613,0
521051,3250,0,FALSE,FALSE,1469670472,1469670472,0
521052,3251,0,FALSE,FALSE,1462653550,1462653550,0
521053,3252,0,FALSE,FALSE,1467030620,1467030620,0
521054,3253,0,FALSE,FALSE,1465792443,1465792443,0
521055,3254,0,FALSE,FALSE,1453644969,1453644969,0
521056,3255,0,FALSE,FALSE,1456522568,1456522568,0
521057,3256,0,FALSE,FALSE,1453735899,1453735899,0
521058,3257,0,FALSE,FALSE,1455100548,1455100548,0
521060,3259,0,FALSE,FALSE,1458792807,1458792807,0
521061,3260,0,FALSE,FALSE,1456258248,1456258248,0
521062,3261,0,FALSE,FALSE,1474781710,1474781710,0
521063,3262,0,FALSE,FALSE,1451746791,1451746791,0
521064,3263,0,FALSE,FALSE,1460600927,1460600927,0
521065,3264,0,FALSE,FALSE,1461603525,1461603525,0
521066,3265,0,FALSE,FALSE,1473006421,1473006421,0
521067,3267,0,FALSE,FALSE,1449280338,1449280338,0
521068,3268,0,FALSE,FALSE,1466428128,1466428128,0
521069,3270,0,FALSE,FALSE,1459694617,1459694617,0
521070,3271,0,FALSE,FALSE,1470332475,1470332475,0
521075,3273,0,FALSE,FALSE,1474159391,1474159391,0
521077,3275,0,FALSE,FALSE,1455459624,1455459624,0
521078,3276,0,FALSE,FALSE,1475202684,1475202684,0
521079,3277,0,FALSE,FALSE,1459517762,1459517762,0
521080,3278,0,FALSE,FALSE,1482309311,1482309311,0
521081,3279,0,FALSE,FALSE,1461623729,1461623729,0
521082,3280,0,FALSE,FALSE,1456041828,1456041828,0
521101,3282,0,FALSE,FALSE,1475660189,1475660189,0
521102,3283,0,FALSE,FALSE,1475660189,1475660189,0
521103,3284,0,FALSE,FALSE,1457093310,1457093310,0
521104,3285,0,FALSE,FALSE,1470153452,1470153452,0
521105,3286,0,FALSE,FALSE,1455045472,1455045472,0
521106,3288,0,FALSE,FALSE,1483233409,1483233409,0
521107,3289,0,FALSE,FALSE,1477196128,1477196128,0
521108,3290,0,FALSE,FALSE,1467942109,1467942109,0
521109,3291,0,FALSE,FALSE,1453655226,1453655226,0
521110,3292,0,FALSE,FALSE,1453334611,1453334611,0
521111,3294,0,FALSE,FALSE,1454948971,1454948971,0
521112,3295,0,FALSE,FALSE,1458634048,1458634048,0
521120,3297,0,FALSE,FALSE,1463972939,1463972939,0
521121,3298,0,FALSE,FALSE,1472010820,1472010820,0
521124,3300,0,FALSE,FALSE,1468422180,1468422180,0
521125,3302,0,FALSE,FALSE,1452119101,1452119101,0
521126,3303,0,FALSE,FALSE,1457025696,1457025696,0
521127,3304,0,FALSE,FALSE,1453408980,1453408980,0
521139,3306,0,FALSE,FALSE,1479329344,1479329344,0
521140,3307,0,FALSE,FALSE,1456750007,1456750007,0
521141,3308,0,FALSE,FALSE,1473940472,1473940472,0
521142,3309,0,FALSE,FALSE,1474050806,1474050806,0
521144,3311,0,FALSE,FALSE,1477419497,1477419497,0
521145,3312,0,FALSE,FALSE,1454968806,1454968806,0
521147,3314,0,FALSE,FALSE,1477662930,1477662930,0
521813,3316,0,FALSE,FALSE,1457270069,1457270069,0
521820,3319,0,FALSE,FALSE,1451866660,1451866660,0
521821,3320,0,FALSE,FALSE,1461049535,1461049535,0
521823,3322,0,FALSE,FALSE,1452630098,1452630098,0
521824,3323,0,FALSE,FALSE,1467511346,1467511346,0
521825,3324,0,FALSE,FALSE,1457456971,1457456971,0
521826,3325,0,FALSE,FALSE,1455580381,1455580381,0
521827,3326,0,FALSE,FALSE,1467715780,1467715780,0
521828,3327,0,FALSE,FALSE,1453641185,1453641185,0
521830,3329,0,FALSE,FALSE,1465246296,1465246296,0
521831,3330,0,FALSE,FALSE,1458675440,1458675440,0
521832,3331,0,FALSE,FALSE,1470774927,1470774927,0
521833,3332,0,FALSE,FALSE,1460436856,1460436856,0
521834,3333,0,FALSE,FALSE,1456388606,1456388606,0
521835,3334,0,FALSE,FALSE,1460662914,1460662914,0
521836,3335,0,FALSE,FALSE,1460662914,1460662914,0
521837,3336,0,FALSE,FALSE,1461696999,1461696999,0
521838,3337,0,FALSE,FALSE,1468122268,1468122268,0
522271,3341,0,FALSE,FALSE,1476359863,1476359863,0
522272,3342,0,FALSE,FALSE,1468891314,1468891314,0
522273,3343,0,FALSE,FALSE,1481838763,1481838763,0
522295,3345,0,FALSE,FALSE,1457384028,1457384028,0
522297,3347,0,FALSE,FALSE,1470994386,1470994386,0
522298,3348,0,FALSE,FALSE,1470994386,1470994386,0
522299,3349,0,FALSE,FALSE,1470335021,1470335021,0
522305,3351,0,FALSE,FALSE,1451362636,1451362636,0
522306,3352,0,FALSE,FALSE,1473521309,1473521309,0
522307,3353,0,FALSE,FALSE,1455132346,1455132346,0
522308,3354,0,FALSE,FALSE,1472413571,1472413571,0
522364,3358,0,FALSE,FALSE,1465591816,1465591816,0
522365,3359,0,FALSE,FALSE,1475771799,1475771799,0
522371,3362,0,FALSE,FALSE,1463855989,1463855989,0
522372,3363,0,FALSE,FALSE,1455158945,1455158945,0
522373,3364,0,FALSE,FALSE,1468046948,1468046948,0
522374,3365,0,FALSE,FALSE,1452361141,1452361141,0
522375,3366,0,FALSE,FALSE,1457017072,1457017072,0
522387,3368,0,FALSE,FALSE,1483119647,1483119647,0
522388,3369,0,FALSE,FALSE,1461257294,1461257294,0
522389,3370,0,FALSE,FALSE,1457204670,1457204670,0
522390,3371,0,FALSE,FALSE,1449700034,1449700034,0
522391,3372,0,FALSE,FALSE,1463147133,1463147133,0
522392,3373,0,FALSE,FALSE,1472499963,1472499963,0